Microsoft Corporation	MSFT
Apple Inc	AAPL
NVIDIA Corporation	NVDA
Alphabet Inc.	GOOGL
Amazon.com, Inc.	AMZN
Meta Platforms, Inc.	META
Berkshire Hathaway Inc.	BRK.B
Eli Lilly and Company	LLY
Taiwan Semiconductor Manufacturing Company Limited	TSM
Broadcom Inc.	AVGO
Novo Nordisk A/S	NVO
Visa Inc.	V
Tesla, Inc.	TSLA
JPMorgan Chase & Co.	JPM
Walmart Inc.	WMT
Exxon Mobil Corporation	XOM
Mastercard Incorporated	MA
UnitedHealth Group Incorporated	UNH
ASML Holding N.V.	ASML
The Procter & Gamble Company	PG
Johnson & Johnson	JNJ
The Home Depot, Inc.	HD
Oracle Corporation	ORCL
Toyota Motor Corporation	TM
Costco Wholesale Corporation	COST
Merck & Co., Inc.	MRK
Chevron Corporation	CVX
AbbVie Inc.	ABBV
Salesforce, Inc.	CRM
Bank of America Corporation	BAC
Netflix, Inc.	NFLX
Advanced Micro Devices, Inc.	AMD
The Coca-Cola Company	KO
Shell plc	SHEL
PepsiCo, Inc.	PEP
Thermo Fisher Scientific Inc.	TMO
Linde plc	LIN
Adobe Inc.	ADBE
AstraZeneca PLC	AZN
SAP SE	SAP
The Walt Disney Company	DIS
Wells Fargo & Company	WFC
Accenture plc	ACN
Cisco Systems, Inc.	CSCO
McDonald's Corporation	MCD
Alibaba Group Holding Limited	BABA
QUALCOMM Incorporated	QCOM
T-Mobile US, Inc.	TMUS
Abbott Laboratories	ABT
Novartis AG	NVS
Caterpillar Inc.	CAT
Danaher Corporation	DHR
Intuit Inc.	INTU
Applied Materials, Inc.	AMAT
GE Aerospace	GE
TotalEnergies SE	TTE
International Business Machines Corporation	IBM
Verizon Communications Inc.	VZ
American Express Company	AXP
ServiceNow, Inc.	NOW
Uber Technologies, Inc.	UBER
Comcast Corporation	CMCSA
Conoco Phillips	COP
HSBC Holdings plc	HSBC
PDD Holdings Inc.	PDD
Texas Instruments Incorporated	TXN
Intel Corporation	INTC
Blackstone Inc.	BX
BHP Group Limited	BHP
Pfizer Inc.	PFE
Amgen Inc.	AMGN
Union Pacific Corporation	UNP
Morgan Stanley	MS
NIKE, Inc.	NKE
Royal Bank of Canada	RY
Philip Morris International Inc.	PM
HDFC Bank Limited	HDB
Intuitive Surgical, Inc.	ISRG
Micron Technology, Inc.	MU
S&P Global Inc.	SPGI
RTX Corp	RTX
Lowe's Companies, Inc.	LOW
Stryker Corporation	SYK
Arm Holdings plc	ARM
NextEra Energy, Inc.	NEE
Honeywell International Inc.	HON
Eaton Corporation plc	ETN
The Goldman Sachs Group, Inc.	GS
Lam Research Corporation	LRCX
The Charles Schwab Corporation	SCHW
United Parcel Service, Inc.	UPS
Booking Holdings Inc.	BKNG
Anheuser-Busch InBev SA/NV	BUD
The Progressive Corporation	PGR
Mitsubishi UFJ Financial Group, Inc.	MUFG
Unilever PLC	UL
AT&T Inc.	T
Elevance Health Inc.	ELV
Citigroup Inc.	C
BlackRock, Inc.	BLK
Rio Tinto Group	RIO
Deere & Company	DE
Prologis, Inc.	PLD
BP p.l.c.	BP
Lockheed Martin Corporation	LMT
The TJX Companies, Inc.	TJX
Sanofi	SNY
Medtronic plc	MDT
The Boeing Company	BA
Airbnb, Inc.	ABNB
Vertex Pharmaceuticals Incorporated	VRTX
Sony Group Corporation	SONY
Cigna Corporation	CI
Petróleo Brasileiro S.A. - Petrobras	PBR
The Toronto-Dominion Bank	TD
Automatic Data Processing, Inc.	ADP
Boston Scientific Corporation	BSX
Chubb Limited	CB
Petróleo Brasileiro S.A. - Petrobras	PBR.A
Bristol-Myers Squibb Company	BMY
Regeneron Pharmaceuticals, Inc.	REGN
Marsh & McLennan Companies, Inc.	MMC
Starbucks Corporation	SBUX
Analog Devices, Inc.	ADI
UBS Group AG	UBS
KLA Corporation	KLAC
ICICI Bank Limited	IBN
Palo Alto Networks, Inc.	PANW
Shopify Inc.	SHOP
Mondelez International, Inc.	MDLZ
Fiserv, Inc.	FI
Southern Copper Corporation	SCCO
CVS Health Corporation	CVS
KKR & Co. Inc.	KKR
HCA Healthcare, Inc.	HCA
Synopsys, Inc.	SNPS
Gilead Sciences, Inc.	GILD
Canadian Natural Resources Limited	CNQ
Arista Networks, Inc.	ANET
Dell Technologies Inc.	DELL
Equinor ASA	EQNR
American Tower Corporation	AMT
Cadence Design Systems, Inc.	CDNS
GSK plc	GSK
Waste Management, Inc.	WM
Canadian National Railway Company	CNI
Chipotle Mexican Grill, Inc.	CMG
The Sherwin-Williams Company	SHW
Canadian Pacific Railway Limited	CP
General Dynamics Corporation	GD
EOG Resources, Inc.	EOG
RELX PLC	RELX
Stellantis N.V.	STLA
Target Corporation	TGT
Sumitomo Mitsui Financial Group, Inc.	SMFG
Diageo plc	DEO
Illinois Tool Works Inc.	ITW
CME Group Inc.	CME
Marathon Petroleum Corporation	MPC
The Southern Company	SO
Intercontinental Exchange, Inc.	ICE
CrowdStrike Holdings, Inc.	CRWD
Ferrari N.V.	RACE
Schlumberger Limited	SLB
Infosys Limited	INFY
MercadoLibre, Inc.	MELI
Duke Energy Corporation	DUK
Marriott International, Inc.	MAR
Enbridge Inc.	ENB
Altria Group, Inc.	MO
Equinix, Inc.	EQIX
Banco Santander, S.A.	SAN
Freeport-McMoRan Inc.	FCX
Colgate-Palmolive Company	CL
Parker-Hannifin Corporation	PH
Phillips 66	PSX
CSX Corporation	CSX
Workday, Inc.	WDAY
Moody's Corporation	MCO
Thomson Reuters Corporation	TRI
McKesson Corporation	MCK
Zoetis Inc.	ZTS
PayPal Holdings, Inc.	PYPL
Amphenol Corporation	APH
Becton, Dickinson and Company	BDX
TransDigm Group Incorporated	TDG
Cintas Corporation	CTAS
Northrop Grumman Corporation	NOC
Bank of Montreal	BMO
Trane Technologies plc	TT
FedEx Corporation	FDX
U.S. Bancorp	USB
Brookfield Corporation	BN
Emerson Electric Co.	EMR
British American Tobacco p.l.c.	BTI
O'Reilly Automotive, Inc.	ORLY
Ecolab Inc.	ECL
Pioneer Natural Resources Company	PXD
Enterprise Products Partners L.P.	EPD
Apollo Global Management, Inc.	APO
PACCAR Inc	PCAR
Honda Motor Co., Ltd.	HMC
Banco Bilbao Vizcaya Argentaria, S.A.	BBVA
Occidental Petroleum Corporation	OXY
Aon plc	AON
Marvell Technology, Inc.	MRVL
Constellation Energy Corporation	CEG
The PNC Financial Services Group, Inc.	PNC
NXP Semiconductors N.V.	NXPI
Coinbase Global, Inc.	COIN
Republic Services, Inc.	RSG
The Bank of Nova Scotia	BNS
Spotify Technology S.A.	SPOT
NetEase, Inc.	NTES
Valero Energy Corporation	VLO
Itaú Unibanco Holding S.A.	ITUB
Roper Technologies, Inc.	ROP
Motorola Solutions, Inc.	MSI
Monster Beverage Corporation	MNST
CRH plc	CRH
América Móvil, SAB de CV	AMX
DoorDash, Inc.	DASH
Norfolk Southern Corporation	NSC
Edwards Lifesciences Corporation	EW
Eni S.p.A.	E
Atlassian Corporation	TEAM
Capital One Financial Corporation	COF
Copart, Inc.	CPRT
Snowflake Inc.	SNOW
Nu Holdings Ltd.	NU
Super Micro Computer, Inc.	SMCI
DexCom, Inc.	DXCM
ING Groep N.V.	ING
Energy Transfer LP	ET
Hilton Worldwide Holdings Inc.	HLT
Vale S.A.	VALE
Air Products and Chemicals, Inc.	APD
AutoZone, Inc.	AZO
Carrier Global Corporation	CARR
Welltower Inc.	WELL
Arthur J. Gallagher & Co.	AJG
MetLife, Inc.	MET
Fortinet, Inc.	FTNT
Autodesk, Inc.	ADSK
The Travelers Companies, Inc.	TRV
3M Company	MMM
D.R. Horton, Inc.	DHI
American International Group, Inc.	AIG
The Estée Lauder Companies Inc.	EL
General Motors Company	GM
Mizuho Financial Group, Inc.	MFG
Ford Motor Company	F
Truist Financial Corporation	TFC
Suncor Energy Inc.	SU
National Grid plc	NGG
Old Dominion Freight Line, Inc.	ODFL
Constellation Brands, Inc.	STZ
Palantir Technologies Inc.	PLTR
Public Storage	PSA
W.W. Grainger, Inc.	GWW
Block, Inc.	SQ
Simon Property Group, Inc.	SPG
Hess Corporation	HES
Nucor Corporation	NUE
Cencora	COR
Interactive Brokers Group, Inc.	IBKR
The Williams Companies, Inc.	WMB
Aflac Incorporated	AFL
Microchip Technology Incorporated	MCHP
ONEOK, Inc.	OKE
Ross Stores, Inc.	ROST
United Rentals, Inc.	URI
Canadian Imperial Bank of Commerce	CM
Realty Income Corporation	O
Newmont Corporation	NEM
Digital Realty Trust, Inc.	DLR
Johnson Controls International plc	JCI
Paychex, Inc.	PAYX
TE Connectivity Ltd.	TEL
Lennar Corporation	LEN
The Allstate Corporation	ALL
Ferguson plc	FERG
The Kraft Heinz Company	KHC
Sempra	SRE
American Electric Power Company, Inc.	AEP
Waste Connections, Inc.	WCN
Joint Stock Company Kaspi.kz	KSPI
IQVIA Holdings Inc.	IQV
Ameriprise Financial, Inc.	AMP
Cummins Inc.	CMI
Datadog, Inc.	DDOG
The Trade Desk, Inc.	TTD
Crown Castle Inc.	CCI
Takeda Pharmaceutical Company Limited	TAK
Keurig Dr Pepper Inc.	KDP
Manulife Financial Corporation	MFC
Kimberly-Clark Corporation	KMB
MSCI Inc.	MSCI
The Bank of New York Mellon Corporation	BK
AMETEK, Inc.	AME
IDEXX Laboratories, Inc.	IDXX
Agilent Technologies, Inc.	A
MPLX LP	MPLX
Dominion Energy, Inc.	D
Fidelity National Information Services, Inc.	FIS
Lululemon Athletica Inc.	LULU
Dow Inc.	DOW
Fastenal Company	FAST
Moderna, Inc.	MRNA
Kinder Morgan, Inc.	KMI
Alcon Inc.	ALC
The Kroger Co.	KR
Banco Santander (Brasil) S.A.	BSBR
Prudential Financial, Inc.	PRU
GE HealthCare Technologies Inc.	GEHC
Lloyds Banking Group plc	LYG
Cenovus Energy Inc.	CVE
Otis Worldwide Corporation	OTIS
Yum! Brands, Inc.	YUM
L3Harris Technologies, Inc.	LHX
Coupang, Inc.	CPNG
Las Vegas Sands Corp.	LVS
The Hershey Company	HSY
Centene Corporation	CNC
Humana Inc.	HUM
Charter Communications, Inc.	CHTR
Imperial Oil Limited	IMO
TC Energy Corporation	TRP
Sysco Corporation	SYY
General Mills, Inc.	GIS
Martin Marietta Materials, Inc.	MLM
Quanta Services, Inc.	PWR
Ingersoll Rand Inc.	IR
Ambev S.A.	ABEV
Corteva, Inc.	CTVA
CoStar Group, Inc.	CSGP
Diamondback Energy, Inc.	FANG
Cheniere Energy, Inc.	LNG
ST Microelectronics	STM
Woodside Energy Group Ltd	WDS
Kenvue Inc.	KVUE
Haleon plc	HLN
Exelon Corporation	EXC
GE Vernova	GEV
Gartner, Inc.	IT
Baidu, Inc.	BIDU
Nasdaq, Inc.	NDAQ
PG&E Corporation	PCG
Halliburton Company	HAL
Vulcan Materials Company	VMC
JD.com, Inc.	JD
Barclays PLC	BCS
Cognizant Technology Solutions Corporation	CTSH
Electronic Arts Inc.	EA
Devon Energy Corporation	DVN
Arch Capital Group Ltd.	ACGL
HubSpot, Inc.	HUBS
Veeva Systems Inc.	VEEV
Baker Hughes Company	BKR
Flutter Entertainment plc	FLUT
LyondellBasell Industries N.V.	LYB
Public Service Enterprise Group Incorporated	PEG
Royal Caribbean Cruises Ltd.	RCL
Rockwell Automation, Inc.	ROK
CDW Corporation	CDW
Dollar General Corporation	DG
Trip.com Group Limited	TCOM
Vertiv Holdings Co	VRT
Monolithic Power Systems, Inc.	MPWR
Global Payments Inc.	GPN
Verisk Analytics, Inc.	VRSK
Cloudflare, Inc.	NET
PPG Industries, Inc.	PPG
Barrick Gold Corporation	GOLD
Archer-Daniels-Midland Company	ADM
Coca-Cola Europacific Partners PLC	CCEP
Xylem Inc.	XYL
Sea Limited	SE
DuPont de Nemours, Inc.	DD
Equifax Inc.	EFX
Agnico Eagle Mines Limited	AEM
Consolidated Edison, Inc.	ED
Deutsche Bank Aktiengesellschaft	DB
Li Auto Inc.	LI
Discover Financial Services	DFS
Delta Air Lines, Inc.	DAL
NatWest Group plc	NWG
Chunghwa Telecom Co., Ltd.	CHT
Sun Life Financial Inc.	SLF
Extra Space Storage Inc.	EXR
Xcel Energy Inc.	XEL
Orange S.A.	ORAN
BCE Inc.	BCE
Fair Isaac Corporation	FICO
The Hartford Financial Services Group, Inc.	HIG
VICI Properties Inc.	VICI
ANSYS, Inc.	ANSS
Fortive Corporation	FTV
Biogen Inc.	BIIB
Wipro Limited	WIT
ON Semiconductor Corporation	ON
Formula One Group - Series A	FWONA
HP Inc.	HPQ
West Pharmaceutical Services, Inc.	WST
Banco Bradesco S.A.	BBD
Formula One Group - Series C	FWONK
Garmin Ltd.	GRMN
ResMed Inc.	RMD
CBRE Group, Inc.	CBRE
Dollar Tree, Inc.	DLTR
Zscaler, Inc.	ZS
Keysight Technologies, Inc.	KEYS
GLOBALFOUNDRIES Inc.	GFS
Mettler-Toledo International Inc.	MTD
Corning Incorporated	GLW
Fomento Económico Mexicano, SAB de CV	FMX
Willis Towers Watson PLC	WTW
eBay Inc.	EBAY
Tractor Supply Company	TSCO
Edison International	EIX
Howmet Aerospace Inc.	HWM
Nutrien Ltd.	NTR
AvalonBay Communities, Inc.	AVB
Zimmer Biomet Holdings, Inc.	ZBH
Westinghouse Air Brake Technologies Corporation	WAB
AppLovin Corporation	APP
T. Rowe Price Group, Inc.	TROW
Raymond James Financial, Inc.	RJF
MongoDB, Inc.	MDB
Mobileye Global Inc.	MBLY
Cardinal Health, Inc.	CAH
Targa Resources Corp.	TRGP
ICON PLC	ICLR
Take-Two Interactive Software, Inc.	TTWO
MicroStrategy Incorporated	MSTR
NVR, Inc.	NVR
Ares Management Corporation	ARES
WEC Energy Group, Inc.	WEC
Church & Dwight Co., Inc.	CHD
Teck Resources Limited	TECK
Ryanair Holdings plc	RYAAY
Rocket Companies, Inc.	RKT
Vistra Corp.	VST
Weyerhaeuser Company	WY
Roblox Corporation	RBLX
ORIX Corporation	IX
Tradeweb Markets Inc.	TW
Ecopetrol S.A.	EC
CGI Inc.	GIB
Prudential plc	PUK
Align Technology, Inc.	ALGN
Dover Corporation	DOV
Telefónica, S.A.	TEF
Fifth Third Bancorp	FITB
Brown-Forman Corporation	BF.A
PulteGroup, Inc.	PHM
HEICO Corporation	HEI.A
Western Digital Corporation	WDC
HEICO Corporation	HEI
Wheaton Precious Metals Corp.	WPM
Axon Enterprise, Inc.	AXON
Broadridge Financial Solutions, Inc.	BR
Equity Residential	EQR
Brown & Brown, Inc.	BRO
ASE Technology Holding Co., Ltd.	ASX
Live Nation Entertainment, Inc.	LYV
TELUS Corporation	TU
Builders FirstSource, Inc.	BLDR
First Citizens BancShares, Inc.	FCNCO
State Street Corporation	STT
Pinterest, Inc.	PINS
American Water Works Company, Inc.	AWK
Franco-Nevada Corporation	FNV
Hewlett Packard Enterprise Company	HPE
Cheniere Energy Partners, L.P.	CQP
First Citizens BancShares, Inc.	FCNCA
Tenaris S.A.	TS
Vodafone Group PLC	VOD
M&T Bank Corporation	MTB
argenx SE	ARGX
Restaurant Brands International Inc.	QSR
Steel Dynamics, Inc.	STLD
Iron Mountain Incorporated	IRM
Molina Healthcare, Inc.	MOH
ArcelorMittal S.A.	MT
Entergy Corporation	ETR
DTE Energy Company	DTE
SBA Communications Corporation	SBAC
Corpay, Inc.	CPAY
Hubbell Incorporated	HUBB
Veralto Corporation	VLTO
Cameco Corporation	CCJ
PTC Inc.	PTC
FirstEnergy Corp.	FE
Rollins, Inc.	ROL
POSCO Holdings Inc.	PKX
Ulta Beauty, Inc.	ULTA
International Flavors & Fragrances Inc.	IFF
Alexandria Real Estate Equities, Inc.	ARE
W. R. Berkley Corporation	WRB
NetApp, Inc.	NTAP
DraftKings Inc.	DKNG
Deckers Outdoor Corporation	DECK
Coterra Energy Inc.	CTRA
Invitation Homes Inc.	INVH
Ball Corporation	BALL
BioNTech SE	BNTX
Eversource Energy	ES
Telkom Indonesia (Persero) Tbk PT	TLK
Baxter International Inc.	BAX
Coca-Cola FEMSA, SAB de CV	KOF
Warner Bros. Discovery, Inc.	WBD
Genuine Parts Company	GPC
Aptiv PLC	APTV
Illumina, Inc.	ILMN
Tyson Foods, Inc.	TSN
Rogers Communications Inc.	RCI
STERIS plc	STE
Entegris, Inc.	ENTG
United Microelectronics Corporation	UMC
Westlake Corporation	WLK
PPL Corporation	PPL
First Solar, Inc.	FSLR
Tencent Music Entertainment Group	TME
LPL Financial Holdings Inc.	LPLA
Huntington Bancshares Incorporated	HBAN
McCormick & Company, Incorporated	MKC
J.B. Hunt Transport Services, Inc.	JBHT
Genmab A/S	GMAB
Ameren Corporation	AEE
Waters Corporation	WAT
Pembina Pipeline Corporation	PBA
Zoom Video Communications, Inc.	ZM
Kellanova Co	K
McCormick & Company, Incorporated	MKC.V
Teledyne Technologies Incorporated	TDY
Cboe Global Markets, Inc.	CBOE
Principal Financial Group, Inc.	PFG
Markel Corporation	MKL
VeriSign, Inc.	VRSN
Alnylam Pharmaceuticals, Inc.	ALNY
Booz Allen Hamilton Holding Corporation	BAH
Reliance Steel & Aluminum Co.	RS
The Cooper Companies, Inc.	COO
Cincinnati Financial Corporation	CINF
Hormel Foods Corporation	HRL
Celsius Holdings, Inc.	CELH
Fortis Inc.	FTS
Williams-Sonoma, Inc.	WSM
Nomura Holdings, Inc.	NMR
Nokia Oyj	NOK
Darden Restaurants, Inc.	DRI
Check Point Software Technologies Ltd.	CHKP
Koninklijke Philips N.V.	PHG
Jacobs Engineering Group Inc.	J
Hologic, Inc.	HOLX
Textron Inc.	TXT
Carnival Corporation & plc	CCL
Omnicom Group Inc.	OMC
Snap Inc.	SNAP
Centrais Elétricas Brasileiras S.A. - Eletrobrás	EBR
KB Financial Group Inc.	KB
Seagate Technology Holdings plc	STX
Carlisle Companies Incorporated	CSL
Regions Financial Corporation	RF
The Clorox Company	CLX
Erie Indemnity Company	ERIE
IDEX Corporation	IEX
GoDaddy Inc.	GDDY
Samsara Inc.	IOT
BioMarin Pharmaceutical Inc.	BMRN
Tyler Technologies, Inc.	TYL
AerCap Holdings N.V.	AER
Celanese Corporation	CE
Cia Paranaense De Energia Copel	ELPC
Pure Storage, Inc.	PSTG
CenterPoint Energy, Inc.	CNP
Warner Music Group Corp.	WMG
Laboratory Corporation of America Holdings	LH
Domino's Pizza, Inc.	DPZ
Ventas, Inc.	VTR
CMS Energy Corporation	CMS
Atmos Energy Corporation	ATO
KE Holdings Inc.	BEKE
Northern Trust Corporation	NTRS
Leidos Holdings, Inc.	LDOS
Expedia Group, Inc.	EXPE
Avery Dennison Corporation	AVY
Avantor, Inc.	AVTR
Expeditors International of Washington, Inc.	EXPD
Best Buy Co., Inc.	BBY
Marathon Oil Corporation	MRO
Lennox International Inc.	LII
DICK'S Sporting Goods, Inc.	DKS
Corebridge Financial, Inc.	CRBG
The Carlyle Group Inc.	CG
EMCOR Group, Inc.	EME
TPG Inc.	TPG
Telefonaktiebolaget LM Ericsson (publ)	ERIC
Watsco, Inc.	WSO
Watsco, Inc.	WSO.B
ZTO Express (Cayman) Inc.	ZTO
Synchrony Financial	SYF
Southwest Airlines Co.	LUV
Loews Corporation	L
EQT Corporation	EQT
Packaging Corporation of America	PKG
Skyworks Solutions, Inc.	SWKS
Gold Fields Limited	GFI
FactSet Research Systems Inc.	FDS
Teradyne, Inc.	TER
Jabil Inc.	JBL
Masco Corporation	MAS
InterContinental Hotels Group PLC	IHG
James Hardie Industries plc	JHX
Enphase Energy, Inc.	ENPH
NRG Energy, Inc.	NRG
CNH Industrial N.V.	CNHI
Telefônica Brasil S.A.	VIV
Okta, Inc.	OKTA
Robinhood Markets, Inc.	HOOD
Everest Group, Ltd.	EG
Akamai Technologies, Inc.	AKAM
BeiGene, Ltd.	BGNE
Hyatt Hotels Corporation	H
Nutanix, Inc.	NTNX
Walgreens Boots Alliance, Inc.	WBA
Brookfield Asset Management Inc.	BAM
Essex Property Trust, Inc.	ESS
Saia, Inc.	SAIA
SS&C Technologies Holdings, Inc.	SSNC
Snap-on Incorporated	SNA
Shinhan Financial Group Co., Ltd.	SHG
Citizens Financial Group, Inc.	CFG
Carvana Co.	CVNA
Nordson Corporation	NDSN
Suzano S.A.	SUZ
Graco Inc.	GGG
Sun Communities, Inc.	SUI
EPAM Systems, Inc.	EPAM
Yum China Holdings, Inc.	YUMC
Mid-America Apartment Communities, Inc.	MAA
Teva Pharmaceutical Industries Limited	TEVA
Zebra Technologies Corporation	ZBRA
Bunge Limited	BG
Trimble Inc.	TRMB
NICE Ltd.	NICE
CF Industries Holdings, Inc.	CF
Manhattan Associates, Inc.	MANH
XPO Logistics, Inc.	XPO
Pool Corporation	POOL
Ovintiv Inc.	OVV
Albemarle Corporation	ALB
Owens Corning	OC
New Oriental Education & Technology Group Inc.	EDU
Bentley Systems, Incorporated	BSY
Magna International Inc.	MGA
TransUnion	TRU
Quest Diagnostics Incorporated	DGX
Rentokil Initial plc	RTO
Molson Coors Beverage Company	TAP.A
Molson Coors Beverage Company	TAP
Host Hotels & Resorts, Inc.	HST
Stanley Black & Decker, Inc.	SWK
Conagra Brands, Inc.	CAG
News Corporation	NWSA
RPM International Inc.	RPM
Texas Pacific Land Corporation	TPL
Avangrid, Inc.	AGR
Fox Corporation	FOXA
United Airlines Holdings, Inc.	UAL
KeyCorp	KEY
Dynatrace, Inc.	DT
Lincoln Electric Holdings, Inc.	LECO
MGM Resorts International	MGM
Logitech International S.A.	LOGI
Viatris Inc.	VTRS
Aspen Technology, Inc.	AZPN
Pentair plc	PNR
Neurocrine Biosciences, Inc.	NBIX
Franklin Resources, Inc.	BEN
RB Global Inc	RBA
Gen Digital Inc.	GEN
TopBuild Corp.	BLD
Fidelity National Financial, Inc.	FNF
Sociedad Química y Minera de Chile S.A.	SQM
TFI International Inc.	TFII
Western Midstream Partners, LP	WES
Healthpeak Properties, Inc.	DOC
Credicorp Ltd.	BAP
LKQ Corporation	LKQ
Morningstar, Inc.	MORN
Toast, Inc.	TOST
Informatica Inc.	INFA
American Homes 4 Rent	AMH
Permian Resources Corporation	PR
Exact Sciences Corporation	EXAS
CEMEX, SAB de CV	CX
Amcor plc	AMCR
International Paper Company	IP
XP Inc.	XP
Revvity, Inc.	RVTY
AECOM	ACM
A. O. Smith Corporation	AOS
Grab Holdings Limited	GRAB
Advanced Drainage Systems, Inc.	WMS
Campbell Soup Company	CPB
Royalty Pharma plc	RPRX
Skye Bioscience, Inc.	SKYE
Toll Brothers, Inc.	TOL
APA Corporation	APA
Plains All American Pipeline, L.P.	PAA
Charles River Laboratories International, Inc.	CRL
US Foods Holding Corp.	USFD
Sirius XM Holdings Inc.	SIRI
WestRock Company	WRK
Ares Capital Corporation	ARCC
Alliant Energy Corporation	LNT
Insulet Corporation	PODD
ShockWave Medical, Inc.	SWAV
nVent Electric plc	NVT
U-Haul Holding Company	UHAL.B
Jack Henry & Associates, Inc.	JKHY
Kimco Realty Corporation	KIM
Burlington Stores, Inc.	BURL
U-Haul Holding Company	UHAL
Medpace Holdings, Inc.	MEDP
Reinsurance Group of America, Incorporated	RGA
NiSource Inc.	NI
DocuSign, Inc.	DOCU
Incyte Corporation	INCY
UDR, Inc.	UDR
Bruker Corporation	BRKR
Equitable Holdings, Inc.	EQH
Floor & Decor Holdings, Inc.	FND
W. P. Carey Inc.	WPC
GFL Environmental Inc.	GFL
The AES Corporation	AES
Flex Ltd.	FLEX
H World Group Limited	HTHT
Brookfield Infrastructure Partners L.P.	BIP
Equity LifeStyle Properties, Inc.	ELS
HF Sinclair Corporation	DINO
Dr. Reddy's Laboratories Limited	RDY
Juniper Networks, Inc.	JNPR
CNA Financial Corporation	CNA
Albertsons Companies, Inc.	ACI
UiPath Inc.	PATH
Evergy, Inc.	EVRG
The J. M. Smucker Company	SJM
Chesapeake Energy Corporation	CHK
The Interpublic Group of Companies, Inc.	IPG
Sarepta Therapeutics, Inc.	SRPT
Lamb Weston Holdings, Inc.	LW
Eastman Chemical Company	EMN
Casey's General Stores, Inc.	CASY
Gaming and Leisure Properties, Inc.	GLPI
DaVita Inc.	DVA
Paycom Software, Inc.	PAYC
Lamar Advertising Company	LAMR
RenaissanceRe Holdings Ltd.	RNR
Wynn Resorts, Limited	WYNN
Ally Financial Inc.	ALLY
CarMax, Inc.	KMX
Natera, Inc.	NTRA
Banco de Chile	BCH
TechnipFMC plc	FTI
Allegion plc	ALLE
Astera Labs, Inc.	ALAB
Twilio Inc.	TWLO
F5, Inc.	FFIV
Comfort Systems USA, Inc.	FIX
United Therapeutics Corporation	UTHR
Huntington Ingalls Industries, Inc.	HII
Rexford Industrial Realty, Inc.	REXR
Solventum Corp.	SOLV
Regal Rexnord Corporation	RRX
Core & Main, Inc.	CNM
Regency Centers Corporation	REG
Companhia de Saneamento Básico do Estado de São Paulo - SABESP	SBS
Fresenius Medical Care AG & Co. KGaA	FMS
Cleveland-Cliffs Inc.	CLF
Performance Food Group Company	PFGC
Qorvo, Inc.	QRVO
Wingstop Inc.	WING
American Financial Group, Inc.	AFG
Procore Technologies, Inc.	PCOR
Clean Harbors, Inc.	CLH
ITT Inc.	ITT
CyberArk Software Ltd.	CYBR
Bio-Techne Corporation	TECH
On Holding AG	ONON
Camden Property Trust	CPT
Kinsale Capital Group, Inc.	KNSL
Smith & Nephew plc	SNN
Zillow Group, Inc.	Z
Lattice Semiconductor Corporation	LSCC
Tetra Tech, Inc.	TTEK
Ralph Lauren Corporation	RL
Aegon N.V.	AEG
BJ's Wholesale Club Holdings, Inc.	BJ
APi Group Corporation	APG
WPP plc	WPP
Service Corporation International	SCI
East West Bancorp, Inc.	EWBC
Catalent, Inc.	CTLT
Bath & Body Works, Inc.	BBWI
Teleflex Incorporated	TFX
Maplebear Inc.	CART
Penske Automotive Group, Inc.	PAG
Tenet Healthcare Corporation	THC
The Mosaic Company	MOS
Affirm Holdings, Inc.	AFRM
AngloGold Ashanti Limited	AU
Universal Health Services, Inc.	UHS
Amdocs Limited	DOX
Trex Company, Inc.	TREX
Texas Roadhouse, Inc.	TXRH
TD SYNNEX Corporation	SNX
CubeSmart	CUBE
WEX Inc.	WEX
Elastic N.V.	ESTC
Fortune Brands Innovations, Inc.	FBIN
Open Text Corporation	OTEX
Unum Group	UNM
Legend Biotech Corporation	LEGN
Unity Software Inc.	U
Repligen Corporation	RGEN
Curtiss-Wright Corporation	CW
Autoliv, Inc.	ALV
Boston Properties, Inc.	BXP
Dayforce Inc	DAY
Grupo Aeroportuario del Sureste, S. A. B. de C. V.	ASR
Paylocity Holding Corporation	PCTY
monday.com Ltd.	MNDY
Bio-Rad Laboratories, Inc.	BIO.B
Tapestry, Inc.	TPR
Coty Inc.	COTY
Essential Utilities, Inc.	WTRG
Korea Electric Power Corporation	KEP
Chemed Corporation	CHE
Crown Holdings, Inc.	CCK
Guidewire Software, Inc.	GWRE
United States Steel Corporation	X
Annaly Capital Management, Inc.	NLY
Stantec Inc.	STN
Henry Schein, Inc.	HSIC
AptarGroup, Inc.	ATR
Assurant, Inc.	AIZ
Duolingo, Inc.	DUOL
Onto Innovation Inc.	ONTO
Antero Resources Corporation	AR
e.l.f. Beauty, Inc.	ELF
The Toro Company	TTC
AGCO Corporation	AGCO
Stevanato Group S.p.A.	STVN
Confluent, Inc.	CFLT
Banco Santander-Chile	BSAC
Pinnacle West Capital Corporation	PNW
Churchill Downs Incorporated	CHDN
Qiagen N.V.	QGEN
SEI Investments Company	SEIC
Jefferies Financial Group Inc.	JEF
Rivian Automotive, Inc.	RIVN
Donaldson Company, Inc.	DCI
Woodward, Inc.	WWD
Roivant Sciences Ltd.	ROIV
Vipshop Holdings Limited	VIPS
Eagle Materials Inc.	EXP
Match Group, Inc.	MTCH
GitLab Inc.	GTLB
Range Resources Corporation	RRC
Tempur Sealy International, Inc.	TPX
Elbit Systems Ltd.	ESLT
Five Below, Inc.	FIVE
Kanzhun Limited	BZ
Caesars Entertainment, Inc.	CZR
Houlihan Lokey, Inc.	HLI
BWX Technologies, Inc.	BWXT
Blue Owl Capital Inc.	OWL
Vail Resorts, Inc.	MTN
American Airlines Group Inc.	AAL
Skechers U.S.A., Inc.	SKX
Roku, Inc.	ROKU
Murphy USA Inc.	MUSA
Bio-Rad Laboratories, Inc.	BIO
SharkNinja, Inc.	SN
Bancolombia S.A.	CIB
Matador Resources Company	MTDR
Jones Lang LaSalle Incorporated	JLL
Weatherford International plc	WFRD
Parsons Corporation	PSN
Graphic Packaging Holding Company	GPK
Grupo Aeroportuario del Pacífico, SAB de CV	PAC
KBR, Inc.	KBR
Pearson plc	PSO
VinFast Auto Ltd.	VFS
Penumbra, Inc.	PEN
Hess Midstream LP	HESM
Ternium S.A.	TX
Light & Wonder, Inc.	LNW
The Gap, Inc.	GPS
YPF SA	YPF
Pilgrim's Pride Corporation	PPC
Globant S.A.	GLOB
Liberty SiriusXM Group - Series A	LSXMA
Liberty SiriusXM Group - Series C	LSXMK
Aramark	ARMK
Federal Realty Investment Trust	FRT
Ascendis Pharma A/S	ASND
Full Truck Alliance Co. Ltd.	YMM
C.H. Robinson Worldwide, Inc.	CHRW
Knight-Swift Transportation Holdings Inc.	KNX
WESCO International, Inc.	WCC
MKS Instruments, Inc.	MKSI
EastGroup Properties, Inc.	EGP
CACI International Inc	CACI
Liberty SiriusXM Group - Series B	LSXMB
Southwestern Energy Company	SWN
TIM S.A.	TIMB
Old Republic International Corporation	ORI
Coherent, Inc.	COHR
Birkenstock Holding plc	BIRK
AppFolio, Inc.	APPF
TKO Group Holdings, Inc.	TKO
Encompass Health Corporation	EHC
MarketAxess Holdings Inc.	MKTX
Oshkosh Corporation	OSK
Amkor Technology, Inc.	AMKR
Etsy, Inc.	ETSY
Generac Holdings Inc.	GNRC
Acuity Brands, Inc.	AYI
Endeavor Group Holdings, Inc.	EDR
Webster Financial Corporation	WBS
Gentex Corporation	GNTX
Dropbox, Inc.	DBX
Futu Holdings Limited	FUTU
Royal Gold, Inc.	RGLD
First Horizon Corporation	FHN
Simpson Manufacturing Co., Inc.	SSD
Kinross Gold Corporation	KGC
Amer Sports, Inc.	AS
WillScot Mobile Mini Holdings Corp.	WSC
The Middleby Corporation	MIDD
Chord Energy Corporation	CHRD
Hasbro, Inc.	HAS
Primerica, Inc.	PRI
BorgWarner Inc.	BWA
NOV Inc.	NOV
Crane Company	CR
Chewy, Inc.	CHWY
Dolby Laboratories, Inc.	DLB
Stifel Financial Corp.	SF
Coca-Cola Consolidated, Inc.	COKE
Levi Strauss & Co.	LEVI
SiteOne Landscape Supply, Inc.	SITE
Lear Corporation	LEA
Cerevel Therapeutics Holdings, Inc.	CERE
Crocs, Inc.	CROX
Robert Half International Inc.	RHI
Norwegian Cruise Line Holdings Ltd.	NCLH
Universal Display Corporation	OLED
Gerdau S.A.	GGB
The Descartes Systems Group Inc.	DSGX
SK Telecom Co.,Ltd	SKM
Viking Therapeutics, Inc.	VKTX
Civitas Resources, Inc.	CIVI
MSA Safety Incorporated	MSA
Omega Healthcare Investors, Inc.	OHI
TAL Education Group	TAL
NNN REIT Inc	NNN
RBC Bearings Incorporated	RBC
Icahn Enterprises L.P.	IEP
Applied Industrial Technologies, Inc.	AIT
Evercore Inc.	EVR
Cytokinetics, Incorporated	CYTK
Lyft, Inc.	LYFT
FTI Consulting, Inc.	FCN
Masimo Corporation	MASI
Lithia Motors, Inc.	LAD
Wayfair Inc.	W
CAVA Group, Inc.	CAVA
MakeMyTrip Limited	MMYT
Ingredion Incorporated	INGR
Mohawk Industries, Inc.	MHK
BellRing Brands, Inc.	BRBR
UL Solutions Inc.	ULS
AAON, Inc.	AAON
Murphy Oil Corporation	MUR
SoFi Technologies, Inc.	SOFI
Summit Materials, Inc.	SUM
Woori Financial Group Inc.	WF
Viper Energy Partners LP	VNOM
PBF Energy Inc.	PBF
FTAI Aviation Ltd	FTAI
UFP Industries, Inc.	UFPI
Darling Ingredients Inc.	DAR
MACOM Technology Solutions Holdings, Inc.	MTSI
ChampionX Corporation	CHX
FMC Corporation	FMC
CCC Intelligent Solutions Holdings Inc.	CCCS
Wix.com Ltd.	WIX
Elanco Animal Health Incorporated	ELAN
Allison Transmission Holdings, Inc.	ALSN
Inspire Medical Systems, Inc.	INSP
Globus Medical, Inc.	GMED
Axalta Coating Systems Ltd.	AXTA
Pan American Silver Corp.	PAAS
MasTec, Inc.	MTZ
XPeng Inc.	XPEV
Fluor Corporation	FLR
The New York Times Company	NYT
Liberty Broadband Corporation	LBRDK
Voya Financial, Inc.	VOYA
Cullen Frost Bankers Inc.	CFR
FirstService Corporation	FSV
Exelixis, Inc.	EXEL
Cognex Corporation	CGNX
The AZEK Company Inc.	AZEK
Jazz Pharmaceuticals plc	JAZZ
Invesco Ltd.	IVZ
HealthEquity, Inc.	HQY
Paramount Global	PARA
Installed Building Products, Inc.	IBP
Nextracker Inc.	NXT
Credit Acceptance Corporation	CACC
Americold Realty Trust, Inc.	COLD
Klaviyo, Inc.	KVYO
Comerica Incorporated	CMA
First Industrial Realty Trust, Inc.	FR
Altair Engineering Inc.	ALTR
The Ensign Group, Inc.	ENSG
Acadia Healthcare Company, Inc.	ACHC
STAG Industrial, Inc.	STAG
SentinelOne, Inc.	S
Reddit, Inc.	RDDT
Vaxcyte, Inc.	PCVX
MINISO Group Holding Limited	MNSO
Arrow Electronics, Inc.	ARW
Watts Water Technologies, Inc.	WTS
Noble Corporation	NE
Commerce Bancshares, Inc.	CBSH
Antero Midstream Corporation	AM
Olin Corporation	OLN
Dillard's, Inc.	DDS
NIO Inc.	NIO
Ryman Hospitality Properties, Inc.	RHP
Liberty Global plc	LBTYK
ATI Inc.	ATI
OGE Energy Corp.	OGE
Ciena Corporation	CIEN
Ubiquiti Inc.	UI
Berry Global Group, Inc.	BERY
Rambus Inc.	RMBS
Chart Industries, Inc.	GTLS
ESAB Corporation	ESAB
Mattel, Inc.	MAT
DENTSPLY SIRONA Inc.	XRAY
BILL Holdings Inc	BILL
AGNC Investment Corp.	AGNC
TriNet Group, Inc.	TNET
West Fraser Timber Co. Ltd.	WFG
Brixmor Property Group Inc.	BRX
H&R Block, Inc.	HRB
AutoNation, Inc.	AN
Vontier Corporation	VNT
Landstar System, Inc.	LSTR
Commercial Metals Company	CMC
Science Applications International Corporation	SAIC
Intra-Cellular Therapies, Inc.	ITCI
Bright Horizons Family Solutions Inc.	BFAM
Sprouts Farmers Market, Inc.	SFM
Alcoa Corporation	AA
Atkore Inc.	ATKR
Fabrinet	FN
SPS Commerce, Inc.	SPSC
RLI Corp.	RLI
Apellis Pharmaceuticals, Inc.	APLS
Western Alliance Bancorporation	WAL
Boyd Gaming Corporation	BYD
CAE Inc.	CAE
Hamilton Lane Incorporated	HLNE
Pinnacle Financial Partners, Inc.	PNFP
Beacon Roofing Supply, Inc.	BECN
EnLink Midstream, LLC	ENLC
Qualys, Inc.	QLYS
Selective Insurance Group, Inc.	SIGI
Flowserve Corporation	FLS
KT Corporation	KT
ICL Group Ltd	ICL
PVH Corp.	PVH
National Storage Affiliates Trust	NSA
Ionis Pharmaceuticals, Inc.	IONS
DT Midstream, Inc.	DTM
GXO Logistics, Inc.	GXO
Post Holdings, Inc.	POST
Taylor Morrison Home Corporation	TMHC
Brookfield Renewable Partners L.P.	BEP
Alamos Gold Inc.	AGI
Choice Hotels International, Inc.	CHH
Zions Bancorporation,NA	ZION
Starwood Property Trust, Inc.	STWD
Blue Owl Capital Corporation	OBDC
ZoomInfo Technologies Inc.	ZI
Gildan Activewear Inc.	GIL
SouthState Corporation	SSB
Popular, Inc.	BPOP
Wintrust Financial Corporation	WTFC
FirstCash Holdings, Inc	FCFS
Element Solutions Inc	ESI
Insight Enterprises, Inc.	NSIT
The Timken Company	TKR
Revolution Medicines, Inc.	RVMD
Reynolds Consumer Products Inc.	REYN
Boise Cascade Company	BCC
Ryan Specialty Holdings, Inc.	RYAN
Brunswick Corporation	BC
Dutch Bros Inc.	BROS
Whirlpool Corporation	WHR
First American Financial Corporation	FAF
Mueller Industries, Inc.	MLI
SM Energy Company	SM
Frontier Communications Parent, Inc.	FYBR
Wyndham Hotels & Resorts, Inc.	WH
Novanta Inc.	NOVT
New Fortress Energy Inc.	NFE
Grifols, S.A.	GRFS
Terreno Realty Corporation	TRNO
Cia Energetica DE Minas Gerais - Cemig	CIG
Harmony Gold Mining Company Limited	HMY
Littelfuse, Inc.	LFUS
Meritage Homes Corporation	MTH
Essent Group Ltd.	ESNT
Tenable Holdings, Inc.	TENB
Lucid Group, Inc.	LCID
Global-e Online Ltd.	GLBE
Kirby Corporation	KEX
Ultrapar Participações S.A.	UGP
Abercrombie & Fitch Co.	ANF
NewMarket Corporation	NEU
Grupo Simec, SAB de CV	SIM
Agree Realty Corporation	ADC
Prosperity Bancshares, Inc.	PB
Genpact Limited	G
BOK Financial Corporation	BOKF
Globe Life Inc.	GL
OneMain Holdings, Inc.	OMF
Apartment Income REIT Corp.	AIRC
Louisiana-Pacific Corporation	LPX
DoubleVerify Holdings, Inc.	DV
Sonoco Products Company	SON
SPX Technologies, Inc.	SPXC
Equitrans Midstream Corporation	ETRN
Thor Industries, Inc.	THO
Freshworks Inc.	FRSH
Zurn Elkay Water Solutions Corporation	ZWS
Sasol Limited	SSL
Cosan S.A.	CSAN
Veren Inc.	CPG
Casella Waste Systems, Inc.	CWST
Harley-Davidson, Inc.	HOG
ADT Inc.	ADT
Valvoline Inc.	VVV
Leonardo DRS, Inc.	DRS
Air Lease Corporation	AL
Lancaster Colony Corporation	LANC
Synovus Financial Corp.	SNV
Healthcare Realty Trust Incorporated	HR
Frontline Ltd.	FRO
BRF S.A.	BRFS
Blueprint Medicines Corporation	BPMC
Nexstar Media Group, Inc.	NXST
Planet Fitness, Inc.	PLNT
Celestica Inc.	CLS
FS KKR Capital Corp.	FSK
MGIC Investment Corporation	MTG
Affiliated Managers Group, Inc.	AMG
Macy's, Inc.	M
Grupo Financiero Galicia S.A.	GGAL
Option Care Health, Inc.	OPCH
Shift4 Payments, Inc.	FOUR
Freshpet, Inc.	FRPT
R1 RCM Inc.	RCM
Colliers International Group Inc.	CIGI
BRP Inc.	DOOO
AXIS Capital Holdings Limited	AXS
Vornado Realty Trust	VNO
Southwest Gas Holdings, Inc.	SWX
MSC Industrial Direct Co., Inc.	MSM
Alaska Air Group, Inc.	ALK
Sensata Technologies Holding plc	ST
Hexcel Corporation	HXL
Allegro MicroSystems, Inc.	ALGM
Smartsheet Inc.	SMAR
Cabot Corporation	CBT
PLDT Inc.	PHI
Armstrong World Industries, Inc.	AWI
Janus Henderson Group plc	JHG
Cia Paranaense De Energia Copel	ELP
Valaris Limited	VAL
Rithm Capital Corp.	RITM
CRISPR Therapeutics AG	CRSP
Polaris Inc.	PII
Federal Signal Corporation	FSS
Pegasystems Inc.	PEGA
Tidewater Inc.	TDW
Silgan Holdings Inc.	SLGN
Alight, Inc.	ALIT
Ryder System, Inc.	R
Old National Bancorp	ONB
Transocean Ltd.	RIG
Bausch + Lomb Corporation	BLCO
Squarespace, Inc.	SQSP
ExlService Holdings, Inc.	EXLS
Moog Inc.	MOG.A
Moog Inc.	MOG.B
Madrigal Pharmaceuticals, Inc.	MDGL
BridgeBio Pharma, Inc.	BBIO
Cadence Bank	CADE
Nova Ltd.	NVMI
MDU Resources Group, Inc.	MDU
Bank OZK	OZK
HashiCorp, Inc.	HCP
UGI Corporation	UGI
Krystal Biotech, Inc.	KRYS
Halozyme Therapeutics, Inc.	HALO
Mr. Cooper Group Inc.	COOP
National Fuel Gas Company	NFG
Maximus, Inc.	MMS
Magnolia Oil & Gas Corporation	MGY
KB Home	KBH
Glaukos Corporation	GKOS
Varonis Systems, Inc.	VRNS
Jackson Financial Inc.	JXN
Vertex, Inc.	VERX
StoneCo Ltd.	STNE
Doximity, Inc.	DOCS
Modine Manufacturing Company	MOD
Turkcell Iletisim Hizmetleri A.S.	TKC
Lincoln National Corporation	LNC
Cirrus Logic, Inc.	CRUS
Flowers Foods, Inc.	FLO
Balchem Corporation	BCPC
Ashland Inc.	ASH
Euronet Worldwide, Inc.	EEFT
Patterson-UTI Energy, Inc.	PTEN
Aurora Innovation, Inc.	AUR
DLocal Limited	DLO
M.D.C. Holdings, Inc.	MDC
Clarivate Plc	CLVT
Rayonier Inc.	RYN
V.F. Corporation	VFC
Enact Holdings, Inc.	ACT
Kyndryl Holdings, Inc.	KD
F.N.B. Corporation	FNB
RH	RH
Brookfield Reinsurance Ltd.	BNRE
Bilibili Inc.	BILI
Sealed Air Corporation	SEE
F&G Annuities & Life, Inc.	FG
Franklin Electric Co., Inc.	FELE
Home Bancshares, Inc. (Conway, AR)	HOMB
Gates Industrial Corporation plc	GTES
Knife River Corporation	KNF
GATX Corporation	GATX
The Hanover Insurance Group, Inc.	THG
Radian Group Inc.	RDN
Capri Holdings Limited	CPRI
Skyline Champion Corporation	SKY
IDACORP, Inc.	IDA
Embraer S.A.	ERJ
Stericycle, Inc.	SRCL
Hilton Grand Vacations Inc.	HGV
Clearway Energy, Inc.	CWEN
American Eagle Outfitters, Inc.	AEO
SLM Corporation	SLM
Marathon Digital Holdings, Inc.	MARA
The Western Union Company	WU
Sunoco LP	SUN
Nuvei Corporation	NVEI
Badger Meter, Inc.	BMI
Columbia Sportswear Company	COLM
Herc Holdings Inc.	HRI
United Bankshares, Inc.	UBSI
Organon & Co.	OGN
Trump Media & Technology Group Corp.	DJT
Essential Properties Realty Trust, Inc.	EPRT
ASGN Incorporated	ASGN
Asbury Automotive Group, Inc.	ABG
PennyMac Financial Services, Inc.	PFSI
Kite Realty Group Trust	KRG
Arcadium Lithium plc	ALTM
Assured Guaranty Ltd.	AGO
Brookfield Reinsurance Ltd	BNRE.A
Valmont Industries, Inc.	VMI
Academy Sports and Outdoors, Inc.	ASO
Ollie's Bargain Outlet Holdings, Inc.	OLLI
American Equity Investment Life Holding Company	AEL
Five9, Inc.	FIVN
Madison Square Garden Sports Corp.	MSGS
Biohaven Pharmaceutical Holding Company Ltd.	BHVN
National Beverage Corp.	FIZZ
Haemonetics Corporation	HAE
NexGen Energy Ltd.	NXE
White Mountains Insurance Group, Ltd.	WTM
Northern Oil and Gas, Inc.	NOG
Workiva Inc.	WK
Enstar Group Limited	ESGR
Avnet, Inc.	AVT
Immunovant, Inc.	IMVT
Signet Jewelers Limited	SIG
Alpha Metallurgical Resources, Inc.	AMR
Terex Corporation	TEX
First Financial Bankshares, Inc.	FFIN
Braze, Inc.	BRZE
Alpine Immune Sciences, Inc.	ALPN
Commvault Systems, Inc.	CVLT
Merit Medical Systems, Inc.	MMSI
Enerplus Corporation	ERF
Advance Auto Parts, Inc.	AAP
Nuvalent, Inc.	NUVL
Itron, Inc.	ITRI
Edgio, Inc.	EGIO
PagSeguro Digital Ltd.	PAGS
Lantheus Holdings, Inc.	LNTH
Huntsman Corporation	HUN
IAC Inc.	IAC
AeroVironment, Inc.	AVAV
H.B. Fuller Company	FUL
Dun & Bradstreet Holdings, Inc.	DNB
Helmerich & Payne, Inc.	HP
Encore Wire Corporation	WIRE
10x Genomics, Inc.	TXG
Vista Energy, SAB de CV	VIST
Perrigo Company plc	PRGO
New Jersey Resources Corporation	NJR
Portland General Electric Company	POR
JFrog Ltd.	FROG
Blackbaud, Inc.	BLKB
Glacier Bancorp, Inc.	GBCI
Algonquin Power & Utilities Corp.	AQN
Enel Chile S.A.	ENIC
Alkermes plc	ALKS
Compania de Minas Buenaventura S.A.	BVN
Avis Budget Group, Inc.	CAR
Symbotic Inc.	SYM
Verra Mobility Corporation	VRRM
Copa Holdings, S.A.	CPA
Inter Parfums, Inc.	IPAR
Insmed Incorporated	INSM
CorVel Corporation	CRVL
Silicon Laboratories Inc.	SLAB
Phillips Edison & Company, Inc.	PECO
Hafnia Limited	HAFN
Brookfield Renewable Corporation	BEPC
Dycom Industries, Inc.	DY
International Game Technology PLC	IGT
Freedom Holding Corp.	FRHC
Main Street Capital Corporation	MAIN
Telecom Argentina S.A.	TEO
Spirit AeroSystems Holdings, Inc.	SPR
Brookfield Infrastructure Corporation	BIPC
Exponent, Inc.	EXPO
iQIYI, Inc.	IQ
IPG Photonics Corporation	IPGP
Insperity, Inc.	NSP
The Chemours Company	CC
Banco Macro S.A.	BMA
The Scotts Miracle-Gro Company	SMG
Acushnet Holdings Corp.	GOLF
Rush Enterprises, Inc.	RUSHA
Kilroy Realty Corporation	KRC
Grand Canyon Education, Inc.	LOPE
Grupo Aeroportuario del Centro Norte, SAB de CV	OMAB
Arcosa, Inc.	ACA
BlackLine, Inc.	BL
Concentrix Corporation	CNXC
UMB Financial Corporation	UMBF
The Brink's Company	BCO
Box, Inc.	BOX
BGC Group, Inc	BGC
Ormat Technologies, Inc.	ORA
Rush Enterprises, Inc.	RUSHB
Power Integrations, Inc.	POWI
Ultragenyx Pharmaceutical Inc.	RARE
Integer Holdings Corporation	ITGR
EchoStar Corporation	SATS
Shake Shack Inc.	SHAK
California Resources Corporation	CRC
Carpenter Technology Corporation	CRS
Matson, Inc.	MATX
The Wendy's Company	WEN
Apple Hospitality REIT, Inc.	APLE
Schneider National, Inc.	SNDR
Liberty Live Group - Series C	LLYVK
Liberty Live Group - Series A	LLYVA
Seadrill Limited	SDRL
GMS Inc.	GMS
Clearwater Analytics Holdings, Inc.	CWAN
Scorpio Tankers Inc.	STNG
B2Gold Corp.	BTG
Avient Corporation	AVNT
Valley National Bancorp	VLY
Braskem S.A.	BAK
SolarEdge Technologies, Inc.	SEDG
Liberty Energy Inc.	LBRT
Companhia Siderúrgica Nacional	SID
CNX Resources Corporation	CNX
DXC Technology Company	DXC
AllianceBernstein Holding L.P.	AB
CBIZ, Inc.	CBZ
Sendas Distribuidora S.A.	ASAI
Plains GP Holdings, L.P.	PAGP
Group 1 Automotive, Inc.	GPI
Tripadvisor, Inc.	TRIP
Columbia Banking System, Inc.	COLB
Hancock Whitney Corporation	HWC
nCino, Inc.	NCNO
EnerSys	ENS
CSW Industrials, Inc.	CSWI
Urban Outfitters, Inc.	URBN
Sibanye Stillwater Limited	SBSW
PACS Group, Inc.	PACS
Kemper Corporation	KMPR
Advanced Energy Industries, Inc.	AEIS
Select Medical Holdings Corporation	SEM
Independence Realty Trust, Inc.	IRT
Dream Finders Homes, Inc.	DFH
Remitly Global, Inc.	RELY
Park Hotels & Resorts Inc.	PK
Synaptics Incorporated	SYNA
Atlas Energy Solutions Inc.	AESI
Black Hills Corporation	BKH
Camtek Ltd.	CAMT
Red Rock Resorts, Inc.	RRR
RadNet, Inc.	RDNT
Teradata Corporation	TDC
CVR Energy, Inc.	CVI
ONE Gas, Inc.	OGS
ArcBest Corporation	ARCB
iRhythm Technologies, Inc.	IRTC
Belden Inc.	BDC
Nelnet, Inc.	NNI
Credo Technology Group Holding Ltd	CRDO
Tower Semiconductor Ltd.	TSEM
PotlatchDeltic Corporation	PCH
Fortrea Holdings Inc.	FTRE
Tri Pointe Homes, Inc.	TPH
The Goodyear Tire & Rubber Company	GT
Quaker Chemical Corporation	KWR
Evolent Health, Inc.	EVH
Crinetics Pharmaceuticals, Inc.	CRNX
Moelis & Company	MC
The Macerich Company	MAC
Crane NXT, Co.	CXT
Otter Tail Corporation	OTTR
Cohen & Steers, Inc.	CNS
LG Display Co., Ltd.	LPL
FormFactor, Inc.	FORM
Millicom International Cellular S.A.	TIGO
Iovance Biotherapeutics, Inc.	IOVA
Axonics, Inc.	AXNX
ImmunityBio, Inc.	IBRX
Kadant Inc.	KAI
ManpowerGroup Inc.	MAN
The Boston Beer Company, Inc.	SAM
Cousins Properties Incorporated	CUZ
Axcelis Technologies, Inc.	ACLS
Marriott Vacations Worldwide Corporation	VAC
ACI Worldwide, Inc.	ACIW
AMTD IDEA Group	AMTD
PowerSchool Holdings, Inc.	PWSC
Prestige Consumer Healthcare Inc.	PBH
United Parks & Resorts Inc.	PRKS
Hecla Mining Company	HL
Alarm.com Holdings, Inc.	ALRM
Black Stone Minerals, L.P.	BSM
Piper Sandler Companies	PIPR
TFS Financial Corporation	TFSL
ALLETE, Inc.	ALE
Lazard Ltd	LAZ
CleanSpark, Inc.	CLSK
Griffon Corporation	GFF
Surgery Partners, Inc.	SGRY
Cactus, Inc.	WHD
The St. Joe Company	JOE
EnPro Industries, Inc.	NPO
SL Green Realty Corp.	SLG
Wolfspeed, Inc.	WOLF
Progyny, Inc.	PGNY
Burford Capital Limited	BUR
GameStop Corp.	GME
Euronav NV	EURN
YETI Holdings, Inc.	YETI
Envista Holdings Corporation	NVST
Hillenbrand, Inc.	HI
Axsome Therapeutics, Inc.	AXSM
M/I Homes, Inc.	MHO
Warrior Met Coal, Inc.	HCC
PNM Resources, Inc.	PNM
Alvotech	ALVO
Corporación Inmobiliaria Vesta, S.A.B. de C.V.	VTMX
Impinj, Inc.	PI
International Bancshares Corporation	IBOC
TORM plc	TRMD
Asana, Inc.	ASAN
Joby Aviation, Inc.	JOBY
ServisFirst Bancshares, Inc.	SFBS
Sanmina Corporation	SANM
Sterling Infrastructure, Inc.	STRL
Blackstone Mortgage Trust, Inc.	BXMT
Howard Hughes Holdings Inc	HHH
Methanex Corporation	MEOH
Spire Inc.	SR
Korn Ferry	KFY
WD-40 Company	WDFC
Bausch Health Companies Inc.	BHC
Enovis Corporation	ENOV
Triple Flag Precious Metals Corp.	TFPM
Graham Holdings Company	GHC
Sotera Health Company	SHC
DigitalOcean Holdings, Inc.	DOCN
Sabra Health Care REIT, Inc.	SBRA
The Simply Good Foods Company	SMPL
Paycor HCM, Inc.	PYCR
Sprout Social, Inc.	SPT
Apogee Therapeutics, Inc.	APGE
Sprinklr, Inc.	CXM
Amicus Therapeutics, Inc.	FOLD
Sportradar Group AG	SRAD
SpringWorks Therapeutics, Inc.	SWTX
Envestnet, Inc.	ENV
Travel + Leisure Co.	TNL
Archrock, Inc.	AROC
Cavco Industries, Inc.	CVCO
Diodes Incorporated	DIOD
IDEAYA Biosciences, Inc.	IDYA
Ameris Bancorp	ABCB
HUTCHMED (China) Limited	HCM
Xenon Pharmaceuticals Inc.	XENE
Nordstrom, Inc.	JWN
Autohome Inc.	ATHM
Polestar Automotive Holding UK PLC	PSNY
Baytex Energy Corp.	BTE
Eldorado Gold Corporation	EGO
CareTrust REIT, Inc.	CTRE
EPR Properties	EPR
Arcellx, Inc.	ACLX
Resideo Technologies, Inc.	REZI
Arrowhead Pharmaceuticals, Inc.	ARWR
Walker & Dunlop, Inc.	WD
Associated Banc-Corp	ASB
Azenta, Inc.	AZTA
Constellium SE	CSTM
Innospec Inc.	IOSP
Q2 Holdings, Inc.	QTWO
Melco Resorts & Entertainment Limited	MLCO
Greif, Inc.	GEF.B
Kontoor Brands, Inc.	KTB
Greif, Inc.	GEF
DigitalBridge Group, Inc.	DBRG
Iridium Communications Inc.	IRDM
Kimbell Royalty Partners, LP	KRP
Qifu Technology Inc.	QFIN
Federated Hermes, Inc.	FHI
Brighthouse Financial, Inc.	BHF
Seaboard Corporation	SEB
United States Cellular Corporation	USM
Tricon Residential Inc.	TCN
Boot Barn Holdings, Inc.	BOOT
TransMedics Group, Inc.	TMDX
Amedisys, Inc.	AMED
Artisan Partners Asset Management Inc.	APAM
MP Materials Corp.	MP
ATS Corporation	ATS
NorthWestern Corporation	NWE
Visteon Corporation	VC
Osisko Gold Royalties Ltd	OR
Nomad Foods Limited	NOMD
Cogent Communications Holdings, Inc.	CCOI
Vishay Intertechnology, Inc.	VSH
Rapid7, Inc.	RPD
Hayward Holdings, Inc.	HAYW
Peabody Energy Corporation	BTU
Cal-Maine Foods, Inc.	CALM
United Community Banks, Inc.	UCBI
Newell Brands Inc.	NWL
John Bean Technologies Corporation	JBT
Construction Partners, Inc.	ROAD
Topgolf Callaway Brands Corp.	MODG
Uranium Energy Corp.	UEC
Pampa Energía S.A.	PAM
Lumentum Holdings Inc.	LITE
Worthington Industries, Inc.	WOR
Kosmos Energy Ltd.	KOS
Tanger Factory Outlet Centers, Inc.	SKT
Instructure Holdings, Inc.	INST
UniFirst Corporation	UNF
ACV Auctions Inc.	ACVA
RingCentral, Inc.	RNG
Grupo Aval Acciones y Valores S.A.	AVAL
Sensient Technologies Corporation	SXT
Steven Madden, Ltd.	SHOO
SITE Centers Corp.	SITC
Transportadora de Gas del Sur S.A.	TGS
Fluence Energy, Inc.	FLNC
Hannon Armstrong Sustainable Infrastructure Capital, Inc.	HASI
QuantumScape Corporation	QS
Arch Resources, Inc.	ARCH
Hercules Capital, Inc.	HTGC
Masonite International Corporation	DOOR
Hims & Hers Health, Inc.	HIMS
Atlantic Union Bankshares Corporation	AUB
Oscar Health, Inc.	OSCR
LivaNova PLC	LIVN
Gulfport Energy Corporation	GPOR
Brady Corporation	BRC
Olink Holding AB (publ)	OLK
MYR Group Inc.	MYRG
Ermenegildo Zegna N.V.	ZGN
Certara, Inc.	CERT
ACADIA Pharmaceuticals Inc.	ACAD
Axos Financial, Inc.	AX
Appian Corporation	APPN
Golub Capital BDC, Inc.	GBDC
QuidelOrtho Corporation	QDEL
Mercury General Corporation	MCY
McGrath RentCorp	MGRC
Life Time Group Holdings, Inc.	LTH
Immunocore Holdings plc	IMCR
Under Armour, Inc.	UAA
Primo Water Corporation	PRMW
Dorman Products, Inc.	DORM
Under Armour, Inc.	UA
Indivior PLC	INDV
Marqeta, Inc.	MQ
Albany International Corp.	AIN
First BanCorp.	FBP
Yelp Inc.	YELP
Innovative Industrial Properties, Inc.	IIPR
CNO Financial Group, Inc.	CNO
Victory Capital Holdings, Inc.	VCTR
LCI Industries	LCII
ABM Industries Incorporated	ABM
Global Business Travel Group, Inc.	GBTG
Broadstone Net Lease, Inc.	BNL
MoonLake Immunotherapeutics	MLTX
BancFirst Corporation	BANF
SkyWest, Inc.	SKYW
MorphoSys AG	MOR
Janux Therapeutics, Inc.	JANX
Kratos Defense & Security Solutions, Inc.	KTOS
Adient plc	ADNT
MGE Energy, Inc.	MGEE
Tecnoglass Inc.	TGLS
Corporación América Airports S.A.	CAAP
GoodRx Holdings, Inc.	GDRX
Alliance Resource Partners, L.P.	ARLP
Savers Value Village, Inc.	SVV
Kulicke and Soffa Industries, Inc.	KLIC
NuStar Energy L.P.	NS
ICF International, Inc.	ICFI
AssetMark Financial Holdings, Inc.	AMK
Neogen Corporation	NEOG
Texas Capital Bancshares, Inc.	TCBI
First Hawaiian, Inc.	FHB
Comstock Resources, Inc.	CRK
Hudbay Minerals Inc.	HBM
LXP Industrial Trust	LXP
Carter's, Inc.	CRI
Atmus Filtration Technologies Inc.	ATMU
C3.ai, Inc.	AI
Avista Corporation	AVA
CG Oncology, Inc.	CGON
Intercorp Financial Services Inc.	IFS
Century Communities, Inc.	CCS
Plexus Corp.	PLXS
Vera Therapeutics, Inc.	VERA
ZKH Group Limited	ZKH
USA Compression Partners, LP	USAC
ESCO Technologies Inc.	ESE
Star Bulk Carriers Corp.	SBLK
Genworth Financial, Inc.	GNW
Zeta Global Holdings Corp.	ZETA
Golar LNG Limited	GLNG
Grocery Outlet Holding Corp.	GO
J&J Snack Foods Corp.	JJSF
COPT Defense Properties	CDP
Golden Ocean Group Limited	GOGL
Outfront Media Inc.	OUT
Materion Corporation	MTRN
Highwoods Properties, Inc.	HIW
Evotec SE	EVO
PROCEPT BioRobotics Corporation	PRCT
First Interstate BancSystem, Inc.	FIBK
Talos Energy Inc.	TALO
NextEra Energy Partners, LP	NEP
WSFS Financial Corporation	WSFS
Summit Therapeutics Inc.	SMMT
Alamo Group Inc.	ALG
Sweetgreen, Inc.	SG
Integra LifeSciences Holdings Corporation	IART
Stride, Inc.	LRN
Flywire Corporation	FLYW
Cathay General Bancorp	CATY
California Water Service Group	CWT
Pactiv Evergreen Inc.	PTVE
Sunrun Inc.	RUN
Tronox Holdings plc	TROX
International Seaways, Inc.	INSW
Hub Group, Inc.	HUBG
PENN Entertainment, Inc.	PENN
Denali Therapeutics Inc.	DNLI
National Health Investors, Inc.	NHI
Celldex Therapeutics, Inc.	CLDX
Vestis Corporation	VSTS
Globalstar, Inc.	GSAT
Premier, Inc.	PINC
Kohl's Corporation	KSS
Silicon Motion Technology Corporation	SIMO
Playtika Holding Corp.	PLTK
American States Water Company	AWR
Green Brick Partners, Inc.	GRBK
Krispy Kreme, Inc.	DNUT
IES Holdings, Inc.	IESC
Embotelladora Andina S.A.	AKO.B
Paymentus Holdings, Inc.	PAY
Manchester United plc	MANU
Cimpress plc	CMPR
Ziff Davis, Inc.	ZD
CONSOL Energy Inc.	CEIX
Arvinas, Inc.	ARVN
InterDigital, Inc.	IDCC
Rumble Inc.	RUM
Lufax Holding Ltd	LU
EVERTEC, Inc.	EVTC
Primoris Services Corporation	PRIM
Corcept Therapeutics Incorporated	CORT
Granite Construction Incorporated	GVA
STAAR Surgical Company	STAA
Rhythm Pharmaceuticals, Inc.	RYTM
PriceSmart, Inc.	PSMT
Sylvamo Corporation	SLVM
Spectrum Brands Holdings, Inc.	SPB
RXO, Inc.	RXO
Strategic Education, Inc.	STRA
Merus N.V.	MRUS
Oceaneering International, Inc.	OII
Bloom Energy Corporation	BE
Lions Gate Entertainment Corp.	LGF.A
Kodiak Gas Services, Inc.	KGS
NMI Holdings, Inc.	NMIH
Teladoc Health, Inc.	TDOC
WNS (Holdings) Limited	WNS
CarGurus, Inc.	CARG
Fulton Financial Corporation	FULT
Patrick Industries, Inc.	PATK
TEGNA Inc.	TGNA
Medical Properties Trust, Inc.	MPW
LegalZoom.com, Inc.	LZ
Banc of California, Inc.	BANC
AvidXchange Holdings, Inc.	AVDX
Frontdoor, Inc.	FTDR
Atlanta Braves Holdings Inc	BATRK
Atlanta Braves Holdings Inc	BATRA
Driven Brands Holdings Inc.	DRVN
Helen of Troy Limited	HELE
ICU Medical, Inc.	ICUI
OSI Systems, Inc.	OSIS
Mueller Water Products, Inc.	MWA
Inari Medical, Inc.	NARI
Leggett & Platt, Incorporated	LEG
O-I Glass, Inc.	OI
TELUS International (Cda) Inc.	TIXT
Intellia Therapeutics, Inc.	NTLA
Mirion Technologies, Inc.	MIR
Kinetik Holdings Inc.	KNTK
Atour Lifestyle Holdings Limited	ATAT
N-able, Inc.	NABL
LGI Homes, Inc.	LGIH
Werner Enterprises, Inc.	WERN
Bank of Hawaii Corporation	BOH
Vericel Corporation	VCEL
Arcos Dorados Holdings Inc.	ARCO
StepStone Group Inc.	STEP
Bloomin' Brands, Inc.	BLMN
Riot Blockchain, Inc.	RIOT
Minerals Technologies Inc.	MTX
LifeStance Health Group, Inc.	LFST
Arbor Realty Trust, Inc.	ABR
Embotelladora Andina S.A.	AKO.A
CONMED Corporation	CNMD
Jamf Holding Corp.	JAMF
Alkami Technology, Inc.	ALKT
JetBlue Airways Corporation	JBLU
Intapp, Inc.	INTA
Community Bank System, Inc.	CBU
Patterson Companies, Inc.	PDCO
RLX Technology Inc.	RLX
Simmons First National Corporation	SFNC
Central Garden & Pet Company	CENT
Chesapeake Utilities Corporation	CPK
Compania Cervecerias Unidas S.A.	CCU
New York Community Bancorp, Inc.	NYCB
Garrett Motion Inc.	GTX
Central Garden & Pet Company	CENTA
Laureate Education, Inc.	LAUR
H&E Equipment Services, Inc.	HEES
Dave & Buster's Entertainment, Inc.	PLAY
CVB Financial Corp.	CVBF
Gibraltar Industries, Inc.	ROCK
Agilysys, Inc.	AGYS
First Advantage Corporation	FA
BBB Foods Inc.	TBBB
Cushman & Wakefield plc	CWK
Prospect Capital Corporation	PSEC
LiveRamp Holdings, Inc.	RAMP
MasterBrand, Inc.	MBC
Tennant Company	TNC
PJT Partners Inc.	PJT
Eastern Bankshares, Inc.	EBC
Guardant Health, Inc.	GH
Sunstone Hotel Investors, Inc.	SHO
Douglas Emmett, Inc.	DEI
Progress Software Corporation	PRGS
Arhaus, Inc.	ARHS
Trinity Industries, Inc.	TRN
Tandem Diabetes Care, Inc.	TNDM
Privia Health Group, Inc.	PRVA
WaFd Inc	WAFD
Rocket Pharmaceuticals, Inc.	RCKT
TG Therapeutics, Inc.	TGTX
Fidelis Insurance Holdings Limited	FIHL
Kymera Therapeutics, Inc.	KYMR
Ginkgo Bioworks Holdings, Inc.	DNA
Cable One, Inc.	CABO
Cellebrite DI Ltd.	CLBT
Sonos, Inc.	SONO
Inter & Co, Inc.	INTR
Cinemark Holdings, Inc.	CNK
First Majestic Silver Corp.	AG
Expro Group Holdings N.V.	XPRO
BBVA Argentina	BBAR
Neumora Therapeutics, Inc.	NMRA
AAR Corp.	AIR
Four Corners Property Trust, Inc.	FCPT
AMN Healthcare Services, Inc.	AMN
Tootsie Roll Industries, Inc.	TR
Geron Corporation	GERN
Mister Car Wash, Inc.	MCW
Ero Copper Corp.	ERO
Atlantica Sustainable Infrastructure plc	AY
Beam Therapeutics Inc.	BEAM
VIZIO Holding Corp.	VZIO
Keros Therapeutics, Inc.	KROS
Semtech Corporation	SMTC
StoneX Group Inc.	SNEX
Crescent Energy Company	CRGY
Dyne Therapeutics, Inc.	DYN
Pacific Premier Bancorp, Inc.	PPBI
Hertz Global Holdings, Inc.	HTZ
ReNew Energy Global Plc	RNW
Xerox Holdings Corporation	XRX
Patria Investments Limited	PAX
ePlus inc.	PLUS
SiriusPoint Ltd.	SPNT
Vital Energy, Inc.	VTLE
Foot Locker, Inc.	FL
Janus International Group, Inc.	JBI
Rogers Corporation	ROG
Independent Bank Corp.	INDB
Upstart Holdings, Inc.	UPST
Coursera, Inc.	COUR
Sitio Royalties Corp.	STR
PagerDuty, Inc.	PD
Lightspeed Commerce Inc.	LSPD
Par Pacific Holdings, Inc.	PARR
Weibo Corporation	WB
John Wiley & Sons, Inc.	WLY
Viasat, Inc.	VSAT
Ardagh Metal Packaging S.A.	AMBP
RxSight, Inc.	RXST
Standex International Corporation	SXI
Veeco Instruments Inc.	VECO
agilon health, inc.	AGL
Delek US Holdings, Inc.	DK
Papa John's International, Inc.	PZZA
PTC Therapeutics, Inc.	PTCT
Six Flags Entertainment Corporation	SIX
Park National Corporation	PRK
First Financial Bancorp.	FFBC
JOYY Inc.	YY
Brinker International, Inc.	EAT
NWTN Inc.	NWTN
Cedar Fair, L.P.	FUN
Galapagos NV	GLPG
HNI Corporation	HNI
Equity Commonwealth	EQC
Calix, Inc.	CALX
Plug Power Inc.	PLUG
Sana Biotechnology, Inc.	SANA
Vermilion Energy Inc.	VET
Mach Natural Resources LP	MNR
Oddity Tech Ltd.	ODD
Energizer Holdings, Inc.	ENR
TreeHouse Foods, Inc.	THS
Teekay Tankers Ltd.	TNK
First Merchants Corporation	FRME
HighPeak Energy, Inc.	HPK
Owens & Minor, Inc.	OMI
Federal Agricultural Mortgage Corporation	AGM.A
Array Technologies, Inc.	ARRY
AZZ Inc.	AZZ
Ultra Clean Holdings, Inc.	UCTT
Astrana Health, Inc.	ASTH
The Andersons, Inc.	ANDE
DiamondRock Hospitality Company	DRH
The GEO Group, Inc.	GEO
Equinox Gold Corp.	EQX
Federal Agricultural Mortgage Corporation	AGM
Hilltop Holdings Inc.	HTH
Criteo S.A.	CRTO
Hillman Solutions Corp.	HLMN
Avidity Biosciences, Inc.	RNA
TowneBank	TOWN
Urban Edge Properties	UE
Schrödinger, Inc.	SDGR
Vista Outdoor Inc.	VSTO
Seacoast Banking Corporation of Florida	SBCF
Amphastar Pharmaceuticals, Inc.	AMPH
Sixth Street Specialty Lending, Inc.	TSLX
Enerpac Tool Group Corp.	EPAC
Ambarella, Inc.	AMBA
MillerKnoll, Inc.	MLKN
Openlane Inc.	KAR
Verint Systems Inc.	VRNT
Winnebago Industries, Inc.	WGO
Stepan Company	SCL
Denison Mines Corp.	DNN
Viavi Solutions Inc.	VIAV
Madison Square Garden Entertainment Corp.	MSGE
Enlight Renewable Energy Ltd	ENLT
BankUnited, Inc.	BKU
Forestar Group Inc.	FOR
Blue Owl Capital Corporation III	OBDE
The Buckle, Inc.	BKE
SiTime Corporation	SITM
TransAlta Corporation	TAC
Kennametal Inc.	KMT
Morgan Stanley Direct Lending Fund	MSDL
Wheels Up Experience Inc.	UP
Navient Corporation	NAVI
Central Puerto S.A.	CEPU
Palomar Holdings, Inc.	PLMR
Coeur Mining, Inc.	CDE
Bowlero Corp.	BOWL
The ODP Corporation	ODP
Syndax Pharmaceuticals, Inc.	SNDX
Virtu Financial, Inc.	VIRT
Pebblebrook Hotel Trust	PEB
Endava plc	DAVA
Alphatec Holdings, Inc.	ATEC
Structure Therapeutics Inc.	GPCR
DHT Holdings, Inc.	DHT
Fastly, Inc.	FSLY
Rocket Lab USA, Inc.	RKLB
SolarWinds Corporation	SWI
Recursion Pharmaceuticals, Inc.	RXRX
Adtalem Global Education Inc.	ATGE
Grupo Televisa, S.A.B.	TV
Donnelley Financial Solutions, Inc.	DFIN
Clear Secure, Inc.	YOU
MaxLinear, Inc.	MXL
Fusion Pharmaceuticals Inc.	FUSN
NeoGenomics, Inc.	NEO
BlackBerry Limited	BB
RLJ Lodging Trust	RLJ
Catalyst Pharmaceuticals, Inc.	CPRX
Delek Logistics Partners, LP	DKL
Grindr Inc.	GRND
WK Kellogg Co	KLG
BRP Group, Inc.	BRP
Edgewell Personal Care Company	EPC
Semrush Holdings, Inc.	SEMR
IAMGOLD Corporation	IAG
Payoneer Global Inc.	PAYO
Barnes Group Inc.	B
Fox Factory Holding Corp.	FOXF
Newmark Group, Inc.	NMRK
Bridge Investment Group Holdings Inc.	BRDG
Helix Energy Solutions Group, Inc.	HLX
Compass Diversified	CODI
GCM Grosvenor Inc	GCMG
Triumph Financial, Inc.	TFIN
NewAmsterdam Pharma Company N.V.	NAMS
Myriad Genetics, Inc.	MYGN
Acadia Realty Trust	AKR
Twist Bioscience Corporation	TWST
Photronics, Inc.	PLAB
Daqo New Energy Corp.	DQ
UFP Technologies, Inc.	UFPT
Worthington Steel, Inc.	WS
PHINIA Inc.	PHIN
ACM Research, Inc.	ACMR
NCR Voyix Corporation	VYX
Dana Incorporated	DAN
CoreCivic, Inc.	CXW
SFL Corporation Ltd.	SFL
Perficient, Inc.	PRFT
BrightSpring Health Services, Inc.	BTSG
MGP Ingredients, Inc.	MGPI
Upbound Group, Inc.	UPBD
Sapiens International Corporation N.V.	SPNS
The Cheesecake Factory Incorporated	CAKE
Mercury Systems, Inc.	MRCY
Huron Consulting Group Inc.	HURN
Hanesbrands Inc.	HBI
Amneal Pharmaceuticals, Inc.	AMRX
Sonic Automotive, Inc.	SAH
Live Oak Bancshares, Inc.	LOB
RPC, Inc.	RES
Bread Financial Holdings, Inc.	BFH
SJW Group	SJW
National Western Life Group, Inc.	NWLI
Columbia Financial, Inc.	CLBK
PC Connection, Inc.	CNXN
Harmony Biosciences Holdings, Inc.	HRMY
Independent Bank Group, Inc.	IBTX
Enova International, Inc.	ENVA
IonQ, Inc.	IONQ
United States Lime & Minerals, Inc.	USLM
PROS Holdings, Inc.	PRO
Nature Wood Group Limited	NWGL
Merchants Bancorp	MBIN
American Healthcare REIT, Inc.	AHR
The Bancorp, Inc.	TBBK
Telephone and Data Systems, Inc.	TDS
Inhibrx, Inc.	INBX
JELD-WEN Holding, Inc.	JELD
Compass, Inc.	COMP
Weis Markets, Inc.	WMK
Supernus Pharmaceuticals, Inc.	SUPN
InvenTrust Properties Corp.	IVT
Stewart Information Services Corporation	STC
Cadeler A/S	CDLR
Ardelyx, Inc.	ARDX
Oxford Industries, Inc.	OXM
Ingevity Corporation	NGVT
Agios Pharmaceuticals, Inc.	AGIO
Studio City International Holdings Limited	MSC
Gentherm Incorporated	THRM
WesBanco, Inc.	WSBC
EverCommerce Inc.	EVCM
Goldman Sachs BDC, Inc.	GSBD
Vicor Corporation	VICR
The Greenbrier Companies, Inc.	GBX
OFG Bancorp	OFG
Renasant Corporation	RNST
Hawkins, Inc.	HWKN
FB Financial Corporation	FBK
Sigma Lithium Corporation	SGML
Trustmark Corporation	TRMK
Gaotu Techedu Inc.	GOTU
Virtus Investment Partners, Inc.	VRTS
Upwork Inc.	UPWK
Dorian LPG Ltd.	LPG
Sandstorm Gold Ltd.	SAND
NextDecade Corporation	NEXT
NBT Bancorp Inc.	NBTB
Super Group (SGHC) Limited	SGHC
Global Industrial Company	GIC
Opendoor Technologies Inc.	OPEN
Afya Limited	AFYA
Addus HomeCare Corporation	ADUS
Getty Images Holdings, Inc.	GETY
Udemy, Inc.	UDMY
Taro Pharmaceutical Industries Ltd.	TARO
Retail Opportunity Investments Corp.	ROIC
Hollysys Automation Technologies Ltd.	HOLI
Protagonist Therapeutics, Inc.	PTGX
XPEL, Inc.	XPEL
Integral Ad Science Holding Corp.	IAS
Warby Parker Inc.	WRBY
Shoals Technologies Group, Inc.	SHLS
Global Net Lease, Inc.	GNL
Distribution Solutions Group, Inc.	DSGR
Global Partners LP	GLP
NOW Inc.	DNOW
Vector Group Ltd.	VGR
U.S. Physical Therapy, Inc.	USPH
Dynavax Technologies Corporation	DVAX
Customers Bancorp, Inc.	CUBI
Akero Therapeutics, Inc.	AKRO
Apollo Commercial Real Estate Finance, Inc.	ARI
National Vision Holdings, Inc.	EYE
Helios Technologies, Inc.	HLIO
Edgewise Therapeutics, Inc.	EWTX
Century Aluminum Company	CENX
eXp World Holdings, Inc.	EXPI
Oaktree Specialty Lending Corporation	OCSL
American Woodmark Corporation	AMWD
Veracyte, Inc.	VCYT
Lakeland Financial Corporation	LKFN
Brookfield Business Corporation	BBUC
NCR Atleos Corporation	NATL
World Kinect Corporation	WKC
Xenia Hotels & Resorts, Inc.	XHR
InMode Ltd.	INMD
NV5 Global, Inc.	NVEE
Banner Corporation	BANR
Powell Industries, Inc.	POWL
Arcus Biosciences, Inc.	RCUS
Frontier Group Holdings, Inc.	ULCC
Empire State Realty Trust, Inc.	ESRT
Liberty Latin America Ltd.	LILAK
Rush Street Interactive, Inc.	RSI
LiveWire Group, Inc.	LVWR
Kura Oncology, Inc.	KURA
Shutterstock, Inc.	SSTK
Borr Drilling Limited	BORR
Cannae Holdings, Inc.	CNNE
Cohu, Inc.	COHU
Sphere Entertainment Co.	SPHR
Guess', Inc.	GES
Empire State Realty OP, L.P.	ESBA
City Holding Company	CHCO
TTM Technologies, Inc.	TTMI
The Bank of N.T. Butterfield & Son Limited	NTB
Goosehead Insurance, Inc	GSHD
Brookfield Business Partners L.P.	BBU
NovoCure Limited	NVCR
AvePoint, Inc.	AVPT
La-Z-Boy Incorporated	LZB
Heartland Financial USA, Inc.	HTLF
VTEX	VTEX
Smith Douglas Homes Corp.	SDHC
Everbridge, Inc.	EVBG
Genesis Energy, L.P.	GEL
LeMaitre Vascular, Inc.	LMAT
Sterling Check Corp.	STER
Ligand Pharmaceuticals Incorporated	LGND
Hamilton Insurance Group, Ltd.	HG
Enterprise Financial Services Corp	EFSC
Meta Materials Inc.	MMAT
Avadel Pharmaceuticals plc	AVDL
Ready Capital Corporation	RC
Gyre Therapeutics, Inc.	GYRE
Diamond Offshore Drilling, Inc.	DO
Morphic Holding, Inc.	MORF
Skyward Specialty Insurance Group, Inc.	SKWD
Getty Realty Corp.	GTY
Kaiser Aluminum Corporation	KALU
Napco Security Technologies, Inc.	NSSC
The Vita Coco Company, Inc.	COCO
Knowles Corporation	KN
CSG Systems International, Inc.	CSGS
CTS Corporation	CTS
Fortuna Silver Mines Inc.	FSM
FinVolution Group	FINV
Zai Lab Limited	ZLAB
Green Plains Inc.	GPRE
ANI Pharmaceuticals, Inc.	ANIP
Tilray Brands, Inc.	TLRY
Orion Engineered Carbons S.A.	OEC
JBG SMITH Properties	JBGS
Danaos Corporation	DAC
V2X, Inc.	VVX
NetScout Systems, Inc.	NTCT
Utz Brands, Inc.	UTZ
Horace Mann Educators Corporation	HMN
Marten Transport, Ltd.	MRTN
Lumen Technologies, Inc.	LUMN
Steelcase Inc.	SCS
Victoria's Secret & Co.	VSCO
trivago N.V.	TRVG
PROG Holdings, Inc.	PRG
Eve Holding, Inc.	EVEX
Falcon's Beyond Global, Inc.	FBYD
Establishment Labs Holdings Inc.	ESTA
Extreme Networks, Inc.	EXTR
Northwest Bancshares, Inc.	NWBI
WisdomTree, Inc.	WT
ADMA Biologics, Inc.	ADMA
National HealthCare Corporation	NHC
Taboola.com Ltd.	TBLA
FLEX LNG Ltd.	FLNG
Agiliti, Inc.	AGTI
Docebo Inc.	DCBO
LTC Properties, Inc.	LTC
Bumble Inc.	BMBL
Northwest Natural Holding Company	NWN
Custom Truck One Source, Inc.	CTOS
Ingles Markets, Incorporated	IMKTA
Montrose Environmental Group, Inc.	MEG
Tarsus Pharmaceuticals, Inc.	TARS
Safehold Inc.	SAFE
Spyre Therapeutics, Inc.	SYRE
SoundHound AI, Inc.	SOUN
Dorchester Minerals, L.P.	DMLP
Advantage Solutions Inc.	ADV
First Watch Restaurant Group, Inc.	FWRG
ProFrac Holding Corp.	ACDC
AdaptHealth Corp.	AHCO
Uniti Group Inc.	UNIT
The Chefs' Warehouse, Inc.	CHEF
Monarch Casino & Resort, Inc.	MCRI
Cadre Holdings, Inc.	CDRE
Ladder Capital Corp	LADR
Opera Limited	OPRA
Veris Residential, Inc.	VRE
Revolve Group, Inc.	RVLV
Costamare Inc.	CMRE
MediaAlpha, Inc.	MAX
First Bancorp	FBNC
Perella Weinberg Partners	PWP
Cracker Barrel Old Country Store, Inc.	CBRL
Phreesia, Inc.	PHR
4D Molecular Therapeutics, Inc.	FDMT
Kronos Worldwide, Inc.	KRO
MeridianLink, Inc.	MLNK
Elme Communities	ELME
First Commonwealth Financial Corporation	FCF
Kaman Corporation	KAMN
Navios Maritime Partners L.P.	NMM
GigaCloud Technology Inc.	GCT
Seabridge Gold Inc.	SA
OneSpaWorld Holdings Limited	OSW
Centerra Gold Inc.	CGAU
Stock Yards Bancorp, Inc.	SYBT
Ichor Holdings, Ltd.	ICHR
Magnite, Inc.	MGNI
Verona Pharma plc	VRNA
New Mountain Finance Corporation	NMFC
E2open Parent Holdings, Inc.	ETWO
AbCellera Biologics Inc.	ABCL
Hope Bancorp, Inc.	HOPE
Playa Hotels & Resorts N.V.	PLYA
JinkoSolar Holding Co., Ltd.	JKS
Kforce Inc.	KFRC
American Assets Trust, Inc.	AAT
Lindsay Corporation	LNN
Apogee Enterprises, Inc.	APOG
Ivanhoe Electric Inc.	IE
Zuora, Inc.	ZUO
National Bank Holdings Corporation	NBHC
Xencor, Inc.	XNCR
Omnicell, Inc.	OMCL
NETSTREIT Corp.	NTST
Orla Mining Ltd.	ORLA
Pacira BioSciences, Inc.	PCRX
Archer Aviation Inc.	ACHR
Caleres, Inc.	CAL
Westamerica Bancorporation	WABC
Diebold Nixdorf, Incorporated	DBD
Marcus & Millichap, Inc.	MMI
Two Harbors Investment Corp.	TWO
Peloton Interactive, Inc.	PTON
PDF Solutions, Inc.	PDFS
Pathward Financial, Inc.	CASH
Kura Sushi USA, Inc.	KRUS
Suburban Propane Partners, L.P.	SPH
New Gold Inc.	NGD
Ironwood Pharmaceuticals, Inc.	IRWD
Calumet Specialty Products Partners, L.P.	CLMT
VSE Corporation	VSEC
Enovix Corporation	ENVX
G-III Apparel Group, Ltd.	GIII
MAG Silver Corp.	MAG
First Busey Corporation	BUSE
Brookdale Senior Living Inc.	BKD
Amplitude, Inc.	AMPL
1st Source Corporation	SRCE
Kiniksa Pharmaceuticals, Ltd.	KNSA
Aspen Aerogels, Inc.	ASPN
PAR Technology Corporation	PAR
Deciphera Pharmaceuticals, Inc.	DCPH
Formula Systems (1985) Ltd.	FORTY
Couchbase, Inc.	BASE
ZIM Integrated Shipping Services Ltd.	ZIM
Stellar Bancorp, Inc.	STEL
Vir Biotechnology, Inc.	VIR
Wabash National Corporation	WNC
Ecovyst Inc.	ECVT
Soleno Therapeutics, Inc.	SLNO
Claros Mortgage Trust, Inc.	CMTG
Day One Biopharmaceuticals, Inc.	DAWN
Beyond, Inc.	BYON
Winmark Corporation	WINA
Columbus McKinnon Corporation	CMCO
Vivid Seats Inc.	SEAT
Prothena Corporation plc	PRTA
Universal Corporation	UVV
Corsair Gaming, Inc.	CRSR
Ocular Therapeutix, Inc.	OCUL
Quanex Building Products Corporation	NX
Fresh Del Monte Produce Inc.	FDP
Harmonic Inc.	HLIT
Lemonade, Inc.	LMND
Adecoagro S.A.	AGRO
Hawaiian Electric Industries, Inc.	HE
Apartment Investment and Management Company	AIV
PennyMac Mortgage Investment Trust	PMT
Arcutis Biotherapeutics, Inc.	ARQT
Natural Resource Partners L.P.	NRP
REV Group, Inc.	REVG
AtriCure, Inc.	ATRC
Koppers Holdings Inc.	KOP
Alexander & Baldwin, Inc.	ALEX
Easterly Government Properties, Inc.	DEA
Jack in the Box Inc.	JACK
Central Securities Corp.	CET
Kennedy-Wilson Holdings, Inc.	KW
Blue Bird Corporation	BLBD
Model N, Inc.	MODN
Safety Insurance Group, Inc.	SAFT
Nicolet Bankshares, Inc.	NIC
Lithium Americas Corp.	LAC
Mirum Pharmaceuticals, Inc.	MIRM
Sally Beauty Holdings, Inc.	SBH
PubMatic, Inc.	PUBM
Genius Sports Limited	GENI
Collegium Pharmaceutical, Inc.	COLL
Cipher Mining Inc.	CIFR
Allegiant Travel Company	ALGT
Sanfilippo (John B.) & Son, Inc	JBSS
Perdoceo Education Corporation	PRDO
MannKind Corporation	MNKD
Digi International Inc.	DGII
S&T Bancorp, Inc.	STBA
GDS Holdings Limited	GDS
EyePoint Pharmaceuticals, Inc.	EYPT
Centessa Pharmaceuticals plc	CNTA
Loma Negra Compañía Industrial Argentina SA	LOMA
Cricut, Inc.	CRCT
IHS Holding Limited	IHS
Maravai LifeSciences Holdings, Inc.	MRVI
Ryerson Holding Corporation	RYI
ZipRecruiter, Inc.	ZIP
Infinera Corporation	INFN
Dole plc	DOLE
Alexander's, Inc.	ALX
Navigator Holdings Ltd.	NVGS
Belite Bio, Inc	BLTE
MFA Financial, Inc.	MFA
Ameresco, Inc.	AMRC
Preferred Bank	PFBC
Immatics N.V.	IMTX
HCI Group, Inc.	HCI
Cars.com Inc.	CARS
MacroGenics, Inc.	MGNX
ChipMOS TECHNOLOGIES INC.	IMOS
TriCo Bancshares	TCBK
Angi Inc.	ANGI
Hyster-Yale Materials Handling, Inc.	HY
Employers Holdings, Inc.	EIG
Target Hospitality Corp.	TH
NerdWallet, Inc.	NRDS
Service Properties Trust	SVC
UMH Properties, Inc.	UMH
Arlo Technologies, Inc.	ARLO
Standard BioTools Inc.	LAB
BrightView Holdings, Inc.	BV
Soho House & Co Inc.	SHCO
Gogo Inc.	GOGO
Veritex Holdings, Inc.	VBTX
Adeia Inc.	ADEA
HUYA Inc.	HUYA
Provident Financial Services, Inc.	PFS
EHang Holdings Limited	EH
Liquidia Corporation	LQDA
Perimeter Solutions, SA	PRM
Benchmark Electronics, Inc.	BHE
Capital Southwest Corporation	CSWC
Camping World Holdings, Inc.	CWH
NovaGold Resources Inc.	NG
SilverCrest Metals Inc.	SILV
SSR Mining Inc.	SSRM
indie Semiconductor, Inc.	INDI
Vital Farms, Inc.	VITL
Sprott Inc.	SII
Scholar Rock Holding Corporation	SRRK
Canada Goose Holdings Inc.	GOOS
Triumph Group, Inc.	TGI
Kenon Holdings Ltd.	KEN
Thermon Group Holdings, Inc.	THR
TriMas Corporation	TRS
TDCX Inc.	TDCX
Hello Group Inc.	MOMO
SP Plus Corporation	SP
MRC Global Inc.	MRC
Empresa Distribuidora y Comercializadora Norte SA	EDN
ScanSource, Inc.	SCSC
Precision Drilling Corporation	PDS
SMART Global Holdings, Inc.	SGH
Paramount Group, Inc.	PGRE
Abivax SA	ABVX
Canadian Solar Inc.	CSIQ
Repay Holdings Corporation	RPAY
BlueLinx Holdings Inc.	BXC
Franklin BSP Realty Trust, Inc.	FBRT
Bain Capital Specialty Finance, Inc.	BCSF
Energy Fuels Inc.	UUUU
Encore Capital Group, Inc.	ECPG
TaskUs, Inc.	TASK
Screaming Eagle Acquisition Corp.	SCRM
U.S. Silica Holdings, Inc.	SLCA
Banco Latinoamericano de Comercio Exterior, S. A.	BLX
Sabre Corporation	SABR
CRA International, Inc.	CRAI
Viridian Therapeutics, Inc.	VRDN
Altice USA, Inc.	ATUS
Scholastic Corporation	SCHL
REX American Resources Corporation	REX
Tuya Inc.	TUYA
Chimera Investment Corporation	CIM
Cassava Sciences, Inc.	SAVA
BioCryst Pharmaceuticals, Inc.	BCRX
NeoGames S.A.	NGMS
Peoples Bancorp Inc.	PEBO
Kyverna Therapeutics, Inc.	KYTX
Golden Entertainment, Inc.	GDEN
Global Blue Group Holding AG	GB
Churchill Capital Corp VII	CVII
Trupanion, Inc.	TRUP
A10 Networks, Inc.	ATEN
Silence Therapeutics plc	SLN
Root, Inc.	ROOT
Sabine Royalty Trust	SBR
Transcat, Inc.	TRNS
Okeanis Eco Tankers Corp.	ECO
MidCap Financial Investment Corporation	MFIC
Portillo's Inc.	PTLO
Barings BDC, Inc.	BBDC
Plymouth Industrial REIT, Inc.	PLYM
Astec Industries, Inc.	ASTE
Ferroglobe PLC	GSM
The Gorman-Rupp Company	GRC
HireRight Holdings Corporation	HRT
PRA Group, Inc.	PRAA
Nuveen Churchill Direct Lending Corp	NCDL
Cronos Group Inc.	CRON
Nexa Resources S.A.	NEXA
Paysafe Limited	PSFE
Ellington Financial Inc.	EFC
Zentalis Pharmaceuticals, Inc.	ZNTL
Olaplex Holdings, Inc.	OLPX
German American Bancorp, Inc.	GABC
The Duckhorn Portfolio, Inc.	NAPA
Metallus Inc.	MTUS
MiMedx Group, Inc.	MDXG
Bicycle Therapeutics plc	BCYC
A-Mark Precious Metals, Inc.	AMRK
Mativ Holdings, Inc.	MATV
QuinStreet, Inc.	QNST
BRC Inc.	BRCC
Praxis Precision Medicines, Inc.	PRAX
QCR Holdings, Inc.	QCRH
Select Energy Services, Inc.	WTTR
IDT Corporation	IDT
Metals Acquisition Corp	MTAL
Nikola Corporation	NKLA
Himax Technologies, Inc.	HIMX
PureCycle Technologies, Inc.	PCT
Simulations Plus, Inc.	SLP
Sage Therapeutics, Inc.	SAGE
Innoviva, Inc.	INVA
Accel Entertainment, Inc.	ACEL
Relay Therapeutics, Inc.	RLAY
89bio, Inc.	ETNB
AMERISAFE, Inc.	AMSF
Sandy Spring Bancorp, Inc.	SASR
Berkshire Hills Bancorp, Inc.	BHLB
Capital Product Partners L.P.	CPLP
Monro, Inc.	MNRO
ProPetro Holding Corp.	PUMP
Centerspace	CSR
Critical Metals Corp.	CRML
ARMOUR Residential REIT, Inc.	ARR
Riskified Ltd.	RSKD
Interface, Inc.	TILE
Granite Ridge Resources, Inc	GRNT
Byline Bancorp, Inc.	BY
Pharvaris N.V.	PHVS
LendingClub Corporation	LC
P10, Inc.	PX
Beazer Homes USA, Inc.	BZH
Alignment Healthcare, Inc.	ALHC
Shoe Carnival, Inc.	SCVL
REGENXBIO Inc.	RGNX
SunCoke Energy, Inc.	SXC
Westrock Coffee Company, LLC	WEST
Immunome, Inc.	IMNM
Ballard Power Systems Inc.	BLDP
Origin Bancorp, Inc.	OBK
Genco Shipping & Trading Limited	GNK
Hovnanian Enterprises, Inc.	HOV
DXP Enterprises, Inc.	DXPE
Autolus Therapeutics plc	AUTL
Enliven Therapeutics, Inc.	ELVN
OceanFirst Financial Corp.	OCFC
Universal Logistics Holdings, Inc.	ULH
ARS Pharmaceuticals, Inc.	SPRY
IMAX Corporation	IMAX
Saul Centers, Inc.	BFS
Titan International, Inc.	TWI
Definitive Healthcare Corp.	DH
IRSA Inversiones y Representaciones SA	IRS
BlackRock TCP Capital Corp.	TCPC
Hudson Pacific Properties, Inc.	HPP
Guild Holdings Company	GHLD
Perspective Therapeutics, Inc.	CATX
Heartland Express, Inc.	HTLD
Enfusion, Inc.	ENFN
OPKO Health, Inc.	OPK
Cryoport, Inc.	CYRX
Healthcare Services Group, Inc.	HCSG
Avanos Medical, Inc.	AVNS
CrossAmerica Partners LP	CAPL
BrightSphere Investment Group Inc.	BSIG
Artivion, Inc.	AORT
Pliant Therapeutics, Inc.	PLRX
Deluxe Corporation	DLX
Noah Holdings Limited	NOAH
Pacific Biosciences of California, Inc.	PACB
Paragon 28, Inc.	FNA
Leslie's, Inc.	LESL
Nayax Ltd.	NYAX
Azul S.A.	AZUL
USANA Health Sciences, Inc.	USNA
SilverBow Resources, Inc.	SBOW
Xometry, Inc.	XMTR
Air Transport Services Group, Inc.	ATSG
Hibbett, Inc.	HIBB
Middlesex Water Company	MSEX
B&G Foods, Inc.	BGS
Kelly Services, Inc.	KELYB
NextNav Inc.	NN
Lithium Americas (Argentina) Corp.	LAAC
American Axle & Manufacturing Holdings, Inc.	AXL
CVR Partners, LP	UAN
Proto Labs, Inc.	PRLB
Republic Bancorp, Inc.	RBCAA
Grid Dynamics Holdings, Inc.	GDYN
Carlyle Secured Lending, Inc.	CGBD
MoneyLion Inc.	ML
Almacenes Éxito S.A.	EXTO
Kelly Services, Inc.	KELYA
NexPoint Residential Trust, Inc.	NXRT
Weave Communications, Inc.	WEAV
Cabaletta Bio, Inc.	CABA
Steel Partners Holdings L.P.	SPLP
CARGO Therapeutics, Inc.	CRGX
Energy Recovery, Inc.	ERII
Core Laboratories N.V.	CLB
World Acceptance Corporation	WRLD
Arcturus Therapeutics Holdings Inc.	ARCT
Nurix Therapeutics, Inc.	NRIX
Matthews International Corporation	MATW
Southside Bancshares, Inc.	SBSI
Piedmont Office Realty Trust, Inc.	PDM
BrightSpire Capital, Inc.	BRSP
Controladora Vuela Compañía de Aviación, SAB de CV	VLRS
National Research Corporation	NRC
Nordic American Tankers Limited	NAT
SLR Investment Corp.	SLRC
Olo Inc.	OLO
Karooooo Ltd.	KARO
Sturm, Ruger & Company, Inc.	RGR
Cytek Biosciences, Inc.	CTKB
Ethan Allen Interiors Inc.	ETD
Bank First Corporation	BFC
Brookline Bancorp, Inc.	BRKL
Algoma Steel Group Inc.	ASTL
Herbalife Nutrition Ltd.	HLF
Universal Technical Institute, Inc.	UTI
Ducommun Incorporated	DCO
Mission Produce, Inc.	AVO
enCore Energy Corp.	EU
Myers Industries, Inc.	MYE
FIGS, Inc.	FIGS
Ramaco Resources, Inc.	METC
Argan, Inc.	AGX
CECO Environmental Corp.	CECO
TechTarget, Inc.	TTGT
NGL Energy Partners LP	NGL
Thryv Holdings, Inc.	THRY
Amerant Bancorp Inc.	AMTB
Unitil Corporation	UTL
Barrett Business Services, Inc.	BBSI
Malibu Boats, Inc.	MBUU
Nextdoor Holdings, Inc.	KIND
Disc Medicine, Inc.	IRON
Tango Therapeutics, Inc.	TNGX
Bioceres Crop Solutions Corp.	BIOX
loanDepot, Inc.	LDI
Tyra Biosciences, Inc.	TYRA
Pediatrix Medical Group, Inc.	MD
Fiverr International Ltd.	FVRR
Haynes International, Inc.	HAYN
Ramaco Resources, Inc.	METCB
Navitas Semiconductor Corporation	NVTS
Westlake Chemical Partners LP	WLKP
Hycroft Mining Holding Corporation	HYMC
Thoughtworks Holding, Inc.	TWKS
Bel Fuse Inc.	BELFB
Abacus Life, Inc.	ABL
Bel Fuse Inc.	BELFA
Everi Holdings Inc.	EVRI
Waldencast plc	WALD
BJ's Restaurants, Inc.	BJRI
Tsakos Energy Navigation Limited	TNP
Lyell Immunopharma, Inc.	LYEL
NFT Ltd.	MI
Viad Corp	VVI
Smith & Wesson Brands, Inc.	SWBI
The RMR Group Inc.	RMR
Enerflex Ltd.	EFXT
Sun Country Airlines Holdings, Inc.	SNCY
Olympic Steel, Inc.	ZEUS
Dianthus Therapeutics, Inc.	DNTH
Kornit Digital Ltd.	KRNT
Lakeland Bancorp, Inc.	LBAI
Pagaya Technologies Ltd.	PGY
Sinclair Broadcast Group, Inc.	SBGI
Redwood Trust, Inc.	RWT
Shenandoah Telecommunications Company	SHEN
Nabors Industries Ltd.	NBR
Brandywine Realty Trust	BDN
HealthStream, Inc.	HSTM
The Real Brokerage Inc.	REAX
VEON Ltd.	VEON
BioLife Solutions, Inc.	BLFS
HilleVax, Inc.	HLVX
Despegar.com, Corp.	DESP
Dril-Quip, Inc.	DRQ
Evolus, Inc.	EOLS
Global Ship Lease, Inc.	GSL
Aurinia Pharmaceuticals Inc.	AUPH
Yalla Group Limited	YALA
Chegg, Inc.	CHGG
Clear Channel Outdoor Holdings, Inc.	CCO
New Found Gold Corp.	NFGC
Treace Medical Concepts, Inc.	TMCI
AdvanSix Inc.	ASIX
International Money Express, Inc.	IMXI
OrthoPediatrics Corp.	KIDS
The First Bancshares, Inc.	FBMS
PureTech Health plc	PRTC
NET Power Inc.	NPWR
WalkMe Ltd.	WKME
Wolverine World Wide, Inc.	WWW
DRDGOLD Limited	DRD
Sky Harbour Group Corporation	SKYH
Bristow Group Inc.	VTOL
VAALCO Energy, Inc.	EGY
Taseko Mines Limited	TGB
Community Trust Bancorp, Inc.	CTBI
Tutor Perini Corporation	TPC
Dime Community Bancshares, Inc.	DCOM
Pitney Bowes Inc.	PBI
Cullinan Oncology, Inc.	CGEM
Hagerty, Inc.	HGTY
Redfin Corporation	RDFN
Betterware de México, S.A.P.I. de C.V.	BWMX
Silk Road Medical, Inc	SILK
Yext, Inc.	YEXT
Canopy Growth Corporation	CGC
Wave Life Sciences Ltd.	WVE
First Mid Bancshares, Inc.	FMBH
Capitol Federal Financial, Inc.	CFFN
CBL & Associates Properties, Inc.	CBL
FTAI Infrastructure Inc.	FIP
Pharming Group N.V.	PHAR
Standard Motor Products, Inc.	SMP
Stratasys Ltd.	SSYS
Aerovate Therapeutics, Inc.	AVTE
Atrion Corporation	ATRI
SunOpta Inc.	STKL
Savara Inc.	SVRA
Varex Imaging Corporation	VREX
Summit Hotel Properties, Inc.	INN
Quanterix Corporation	QTRX
Bitdeer Technologies Group	BTDR
Premier Financial Corp.	PFC
AMC Entertainment Holdings, Inc.	AMC
Community Healthcare Trust Incorporated	CHCT
Radware Ltd.	RDWR
Associated Capital Group, Inc.	AC
Armada Hoffler Properties, Inc.	AHH
Omega Flex, Inc.	OFLX
Lavoro Limited	LVRO
Longboard Pharmaceuticals, Inc.	LBPH
Dynex Capital, Inc.	DX
Hut 8 Mining Corp.	HUT
Vitesse Energy, Inc.	VTS
PennantPark Floating Rate Capital Ltd.	PFLT
Prime Medicine, Inc.	PRME
ConnectOne Bancorp, Inc.	CNOB
Mitek Systems, Inc.	MITK
EverQuote, Inc.	EVER
Mind Medicine (MindMed) Inc.	MNMD
ChargePoint Holdings, Inc.	CHPT
Gatos Silver, Inc.	GATO
Cogent Biosciences, Inc.	COGT
ProAssurance Corporation	PRA
Ambac Financial Group, Inc.	AMBC
Hawaiian Holdings, Inc.	HA
Cresud S.A.C.I.F. y A.	CRESY
Conduent Incorporated	CNDT
Diversified Energy Company PLC	DEC
Trinity Capital Inc.	TRIN
enGene Holdings Inc.	ENGN
Amalgamated Financial Corp.	AMAL
Altus Power, Inc.	AMPS
Insteel Industries, Inc.	IIIN
Clearwater Paper Corporation	CLW
KKR Real Estate Finance Trust Inc.	KREF
Ares Acquisition Corporation II	AACT
Teekay Corporation	TK
Stoke Therapeutics, Inc.	STOK
ORIC Pharmaceuticals, Inc.	ORIC
Ardmore Shipping Corporation	ASC
Sable Offshore Corp.	SOC
Enviri Corporation	NVRI
Absci Corporation	ABSI
Obsidian Energy Ltd.	OBE
Forward Air Corporation	FWRD
Stagwell Inc.	STGW
ALX Oncology Holdings Inc.	ALXO
Dine Brands Global, Inc.	DIN
Zymeworks Inc.	ZYME
CureVac N.V.	CVAC
B. Riley Financial, Inc.	RILY
Centrus Energy Corp.	LEU
SpartanNash Company	SPTN
Nuvation Bio Inc.	NUVB
Iris Energy Limited	IREN
Grupo Supervielle S.A.	SUPV
Mineralys Therapeutics, Inc.	MLYS
Berry Corporation	BRY
Allogene Therapeutics, Inc.	ALLO
Tompkins Financial Corporation	TMP
Accolade, Inc.	ACCD
Eagle Bancorp, Inc.	EGBN
Kingsoft Cloud Holdings Limited	KC
New York Mortgage Trust, Inc.	NYMT
Newpark Resources, Inc.	NR
CI&T Inc	CINT
Y-mAbs Therapeutics, Inc.	YMAB
Crescent Capital BDC, Inc.	CCAP
Annexon, Inc.	ANNX
Mercer International Inc.	MERC
Riley Exploration Permian, Inc.	REPX
The Hackett Group, Inc.	HCKT
CrossFirst Bankshares, Inc.	CFB
SIGA Technologies, Inc.	SIGA
Silvercorp Metals Inc.	SVM
Snap One Holdings Corp.	SNPO
Cass Information Systems, Inc.	CASS
Fulgent Genetics, Inc.	FLGT
SunCar Technology Group Inc.	SDA
TeraWulf Inc.	WULF
Evolv Technologies Holdings, Inc.	EVLV
Heidrick & Struggles International, Inc.	HSII
Nkarta, Inc.	NKTX
SI-BONE, Inc.	SIBN
Alpha and Omega Semiconductor Limited	AOSL
Blend Labs, Inc.	BLND
Mesoblast Limited	MESO
MarineMax, Inc.	HZO
Similarweb Ltd.	SMWB
PropertyGuru Limited	PGRU
Cross Country Healthcare, Inc.	CCRN
LanzaTech Global, Inc.	LNZA
Diversified Healthcare Trust	DHC
Lifezone Metals Limited	LZM
AnaptysBio, Inc.	ANAB
Olema Pharmaceuticals, Inc.	OLMA
Preformed Line Products Company	PLPC
The Pennant Group, Inc.	PNTG
Vimeo, Inc.	VMEO
SolarMax Technology, Inc.	SMXT
Open Lending Corporation	LPRO
Heritage Financial Corporation	HFWA
TETRA Technologies, Inc.	TTI
Nu Skin Enterprises, Inc.	NUS
Korro Bio, Inc.	KRRO
Old Second Bancorp, Inc.	OSBC
Matterport, Inc.	MTTR
Novavax, Inc.	NVAX
Cardlytics, Inc.	CDLX
EZCORP, Inc.	EZPW
Fidus Investment Corporation	FDUS
Oatly Group AB	OTLY
Great Southern Bancorp, Inc.	GSBC
Verve Therapeutics, Inc.	VERV
Anywhere Real Estate Inc.	HOUS
LSB Industries, Inc.	LXU
Anterix Inc.	ATEX
Covenant Logistics Group, Inc.	CVLG
UWM Holdings Corporation	UWMC
Astria Therapeutics, Inc.	ATXS
CION Investment Corporation	CION
Phathom Pharmaceuticals, Inc.	PHAT
Perion Network Ltd.	PERI
OmniAb, Inc.	OABI
Compass Minerals International, Inc.	CMP
Valneva SE	VALN
Embecta Corp.	EMBC
First Community Bankshares, Inc.	FCBC
Ranpak Holdings Corp.	PACK
HBT Financial, Inc.	HBT
United Natural Foods, Inc.	UNFI
EVgo, Inc.	EVGO
Talkspace, Inc.	TALK
International General Insurance Holdings Ltd.	IGIC
Astronics Corporation	ATRO
Montauk Renewables, Inc.	MNTK
Cool Company Ltd.	CLCO
Exscientia plc	EXAI
Biglari Holdings Inc.	BH
Tiptree Inc.	TIPT
GH Research PLC	GHRS
Vinci Partners Investments Ltd.	VINP
Qudian Inc.	QD
Planet Labs PBC	PL
Alector, Inc.	ALEC
Magic Software Enterprises Ltd.	MGIC
TMC the metals company Inc.	TMC
Mercantile Bank Corporation	MBWM
Miller Industries, Inc.	MLR
MetroCity Bankshares, Inc.	MCBS
Fate Therapeutics, Inc.	FATE
Auna S.A.	AUNA
COMPASS Pathways plc	CMPS
NB Bancorp, Inc.	NBBK
Permian Basin Royalty Trust	PBT
Hesai Group	HSAI
FRP Holdings, Inc.	FRPH
Altimmune, Inc.	ALT
Mesa Laboratories, Inc.	MLAB
TXO Partners L.P.	TXO
ArriVent BioPharma, Inc.	AVBP
TPG RE Finance Trust, Inc.	TRTX
1-800-FLOWERS.COM, Inc.	FLWS
National Presto Industries, Inc.	NPK
North American Construction Group Ltd.	NOA
AlTi Global, Inc.	ALTI
Arko Corp.	ARKO
European Wax Center, Inc.	EWCZ
Endeavour Silver Corp.	EXK
Gray Television, Inc.	GTN
Highest Performances Holdings Inc.	HPH
Celcuity Inc.	CELC
Cerence Inc.	CRNC
ECARX Holdings, Inc.	ECX
Nano-X Imaging Ltd.	NNOX
Eventbrite, Inc.	EB
Karat Packaging Inc.	KRT
Univest Financial Corporation	UVSP
SandRidge Energy, Inc.	SD
nLIGHT, Inc.	LASR
Castle Biosciences, Inc.	CSTL
United Fire Group, Inc.	UFCS
Liquidity Services, Inc.	LQDT
AltC Acquisition Corp.	ALCC
Taysha Gene Therapies, Inc.	TSHA
Whitestone REIT	WSR
Chuy's Holdings, Inc.	CHUY
Hippo Holdings Inc.	HIPO
Applied Therapeutics, Inc.	APLT
Bitfarms Ltd.	BITF
The Hain Celestial Group, Inc.	HAIN
Universal Insurance Holdings, Inc.	UVE
Global Medical REIT Inc.	GMRE
GeoPark Limited	GPRK
Clean Energy Fuels Corp.	CLNE
Carrols Restaurant Group, Inc.	TAST
AMTD Digital Inc.	HKD
Nano Dimension Ltd.	NNDM
IGM Biosciences, Inc.	IGMS
McEwen Mining Inc.	MUX
Bally's Corporation	BALY
i3 Verticals, Inc.	IIIV
Core Scientific, Inc.	CORZ
Titan Machinery Inc.	TITN
CompoSecure, Inc.	CMPO
Velocity Financial, Inc.	VEL
AST SpaceMobile, Inc.	ASTS
InnovAge Holding Corp.	INNV
Phibro Animal Health Corporation	PAHC
Great Lakes Dredge & Dock Corporation	GLDD
SES AI Corporation	SES
Gladstone Commercial Corporation	GOOD
SNDL Inc.	SNDL
Seritage Growth Properties	SRG
Safe Bulkers, Inc.	SB
Allient Inc.	ALNT
Palmer Square Capital BDC Inc.	PSBD
Ituran Location and Control Ltd.	ITRN
IRadimed Corporation	IRMD
Acelyrin, Inc.	SLRN
Luminar Technologies, Inc.	LAZR
Arbutus Biopharma Corporation	ABUS
Enhabit, Inc.	EHAB
SecureWorks Corp.	SCWX
Business First Bancshares, Inc.	BFST
Tourmaline Bio, Inc.	TRML
Bowman Consulting Group Ltd.	BWMN
Franklin Covey Co.	FC
Sunnova Energy International Inc.	NOVA
UroGen Pharma Ltd.	URGN
Kimball Electronics, Inc.	KE
Central Pacific Financial Corp.	CPF
UP Fintech Holding Limited	TIGR
Coastal Financial Corporation	CCB
Neurogene Inc.	NGNE
Mobile-health Network Solutions	MNDR
Calliditas Therapeutics AB (publ)	CALT
Horizon Bancorp, Inc.	HBNC
ADS-TEC Energy PLC	ADSE
Runway Growth Finance Corp.	RWAY
C4 Therapeutics, Inc.	CCCC
Editas Medicine, Inc.	EDIT
American National Bankshares Inc.	AMNB
American Coastal Insurance Corporation	ACIC
MultiPlan Corporation	MPLN
Farmland Partners Inc.	FPI
DoubleDown Interactive Co., Ltd.	DDI
Reservoir Media, Inc.	RSVR
Midland States Bancorp, Inc.	MSBI
Douglas Dynamics, Inc.	PLOW
Ennis, Inc.	EBF
Holley Inc.	HLLY
KalVista Pharmaceuticals, Inc.	KALV
Intchains Group Limited	ICG
Haverty Furniture Companies, Inc.	HVT.A
Acacia Research Corporation	ACTG
Dada Nexus Limited	DADA
Gladstone Investment Corporation	GAIN
Aris Mining Corporation	ARMN
CEVA, Inc.	CEVA
TrustCo Bank Corp NY	TRST
Equity Bancshares, Inc.	EQBK
Orthofix Medical Inc.	OFIX
Youdao, Inc.	DAO
Consolidated Communications Holdings, Inc.	CNSL
SmartRent, Inc.	SMRT
FuelCell Energy, Inc.	FCEL
Legacy Housing Corporation	LEGH
Haverty Furniture Companies, Inc.	HVT
3D Systems Corporation	DDD
LendingTree, Inc.	TREE
Crawford & Company	CRD.A
Waterdrop Inc.	WDH
The York Water Company	YORW
Lightwave Logic, Inc.	LWLG
Independent Bank Corporation	IBCP
Jin Medical International Ltd.	ZJYL
Radius Health, Inc.	RDUS
Lexicon Pharmaceuticals, Inc.	LXRX
Travere Therapeutics, Inc.	TVTX
Heritage Commerce Corp	HTBK
Cambridge Bancorp	CATC
CS Disco, Inc.	LAW
Nevro Corp.	NVRO
PetIQ, Inc.	PETQ
Boston Omaha Corporation	BOC
BrasilAgro - Companhia Brasileira de Propriedades Agrícolas	LND
Digimarc Corporation	DMRC
ACCO Brands Corporation	ACCO
Crawford & Company	CRD.B
Chatham Lodging Trust	CLDT
The Manitowoc Company, Inc.	MTW
Ur-Energy Inc.	URG
BigCommerce Holdings, Inc.	BIGC
RCI Hospitality Holdings, Inc.	RICK
Turning Point Brands, Inc.	TPB
Designer Brands Inc.	DBI
Ribbon Communications Inc.	RBBN
Cognyte Software Ltd.	CGNT
Gravity Co., Ltd.	GRVY
D-Market Elektronik Hizmetler ve Ticaret A.S.	HEPS
Vitru Limited	VTRU
Third Harmonic Bio, Inc.	THRD
One Liberty Properties, Inc.	OLP
Bandwidth Inc.	BAND
Hudson Technologies, Inc.	HDSN
Nerdy, Inc.	NRDY
Oil-Dri Corporation of America	ODC
Torrid Holdings Inc.	CURV
Daily Journal Corporation	DJCO
ICZOOM Group Inc.	IZM
Fulcrum Therapeutics, Inc.	FULC
Theravance Biopharma, Inc.	TBPH
GrafTech International Ltd.	EAF
Gladstone Land Corporation	LAND
Petco Health and Wellness Company, Inc.	WOOF
Universal Health Realty Income Trust	UHT
AMC Networks Inc.	AMCX
Cantaloupe, Inc.	CTLP
Biomea Fusion, Inc.	BMEA
Mersana Therapeutics, Inc.	MRSN
National CineMedia, Inc.	NCMI
SkyWater Technology, Inc.	SKYT
Voyager Therapeutics, Inc.	VYGR
Southern Missouri Bancorp, Inc.	SMBC
Spirit Airlines, Inc.	SAVE
Xperi Holding Corporation	XPER
Greene County Bancorp, Inc.	GCBC
PowerFleet, Inc.	PWFL
The Beauty Health Company	SKIN
Farmers National Banc Corp.	FMNB
American Superconductor Corporation	AMSC
Aveanna Healthcare Holdings Inc.	AVAH
Jumia Technologies AG	JMIA
Lilium N.V.	LILM
Hanmi Financial Corporation	HAFC
biote Corp.	BTMD
Harrow Health, Inc.	HROW
Five Star Bancorp	FSBC
Xponential Fitness, Inc.	XPOF
Clearfield, Inc.	CLFD
GDEV Inc.	GDEV
PennantPark Investment Corporation	PNNT
Larimar Therapeutics, Inc.	LRMR
Shattuck Labs, Inc.	STTK
Methode Electronics, Inc.	MEI
Donegal Group Inc.	DGICA
Vishay Precision Group, Inc.	VPG
Gladstone Capital Corporation	GLAD
CareDx, Inc	CDNA
Capital City Bank Group, Inc.	CCBG
Global Indemnity Group, LLC	GBLI
Donegal Group Inc.	DGICB
Agriculture & Natural Solutions Acquisition Corporation	ANSC
Limbach Holdings, Inc.	LMB
Yiren Digital Ltd.	YRD
Denny's Corporation	DENN
Stoneridge, Inc.	SRI
Ocugen, Inc.	OCGN
Slam Corp.	SLAM
Replimune Group, Inc.	REPL
Oculis Holding AG	OCS
Daktronics, Inc.	DAKT
Heron Therapeutics, Inc.	HRTX
Cementos Pacasmayo S.A.A.	CPAC
Johnson Outdoors Inc.	JOUT
Adaptive Biotechnologies Corporation	ADPT
Greenfire Resources Ltd	GFR
NETGEAR, Inc.	NTGR
SunPower Corporation	SPWR
Entrada Therapeutics, Inc.	TRDA
Calavo Growers, Inc.	CVGW
fuboTV Inc.	FUBO
Diamond Hill Investment Group, Inc.	DHIL
Virgin Galactic Holdings, Inc.	SPCE
Aris Water Solutions, Inc.	ARIS
Aviat Networks, Inc.	AVNW
Applied Optoelectronics, Inc.	AAOI
ZimVie Inc.	ZIMV
Orchid Island Capital, Inc.	ORC
Revance Therapeutics, Inc.	RVNC
Beyond Meat, Inc.	BYND
Corbus Pharmaceuticals Holdings, Inc.	CRBP
Greenlight Capital Re, Ltd.	GLRE
Valhi, Inc.	VHI
HarborOne Bancorp, Inc.	HONE
Camden National Corporation	CAC
Cibus, Inc.	CBUS
Landsea Homes Corporation	LSEA
Avid Bioservices, Inc.	CDMO
LSI Industries Inc.	LYTS
Washington Trust Bancorp, Inc.	WASH
Dave Inc.	DAVE
Overseas Shipholding Group, Inc.	OSG
Green Dot Corporation	GDOT
First Financial Corporation	THFF
HomeTrust Bancshares, Inc.	HTBI
ATN International, Inc.	ATNI
PepGen Inc.	PEPG
NuScale Power Corporation	SMR
iTeos Therapeutics, Inc.	ITOS
Genie Energy Ltd.	GNE
Jasper Therapeutics, Inc.	JSPR
Lindblad Expeditions Holdings, Inc.	LIND
MaxCyte, Inc.	MXCT
Ring Energy, Inc.	REI
Marinus Pharmaceuticals, Inc.	MRNS
Invesco Mortgage Capital Inc.	IVR
Community Health Systems, Inc.	CYH
Seneca Foods Corporation	SENEB
Peapack-Gladstone Financial Corporation	PGC
Mereo BioPharma Group plc	MREO
Skeena Resources Limited	SKE
The Marcus Corporation	MCS
CompX International Inc.	CIX
OraSure Technologies, Inc.	OSUR
Tejon Ranch Co.	TRC
CNB Financial Corporation	CCNE
South Plains Financial, Inc.	SPFI
Alta Equipment Group Inc.	ALTG
VNET Group, Inc.	VNET
Lands' End, Inc.	LE
Groupon, Inc.	GRPN
Northeast Bank	NBN
Tevogen Bio Holdings Inc.	TVGN
Lexeo Therapeutics, Inc.	LXEO
ProKidney Corp.	PROK
NVE Corporation	NVEC
SOS Limited	SOS
Excelerate Energy, Inc.	EE
Roadzen, Inc.	RDZN
ATRenew Inc.	RERE
Nabors Energy Transition Corp. II	NETD
Atlanticus Holdings Corporation	ATLC
Pulse Biosciences, Inc.	PLSE
Build-A-Bear Workshop, Inc.	BBW
Latham Group, Inc.	SWIM
Seneca Foods Corporation	SENEA
Nexxen International Ltd.	NEXN
The Shyft Group, Inc.	SHYF
Zhihu Inc.	ZH
Alerus Financial Corporation	ALRS
Movado Group, Inc.	MOV
Gogoro Inc.	GGR
Resources Connection, Inc.	RGP
Emerald Holding, Inc.	EEX
Concrete Pumping Holdings, Inc.	BBCP
Solid Biosciences Inc.	SLDB
Tellurian Inc.	TELL
Amarin Corporation plc	AMRN
L Catterton Asia Acquisition Corp	LCAA
Backblaze, Inc.	BLZE
Burke & Herbert Bank & Trust Company	BHRB
LifeMD, Inc.	LFMD
TTEC Holdings, Inc.	TTEC
Consolidated Water Co. Ltd.	CWCO
Oppenheimer Holdings Inc.	OPY
First Foundation Inc.	FFWM
Contineum Therapeutics, Inc.	CTNM
NL Industries, Inc.	NL
Qurate Retail, Inc.	QRTEA
Maui Land & Pineapple Company, Inc.	MLP
CTO Realty Growth, Inc.	CTO
Surmodics, Inc.	SRDX
Marine Products Corporation	MPX
Unisys Corporation	UIS
Alto Neuroscience, Inc.	ANRO
Zynex, Inc.	ZYXI
NeuroPace, Inc.	NPCE
Metropolitan Bank Holding Corp.	MCB
Qurate Retail, Inc.	QRTEB
Ares Commercial Real Estate Corporation	ACRE
Atai Life Sciences N.V.	ATAI
W&T Offshore, Inc.	WTI
Esquire Financial Holdings, Inc.	ESQ
Prelude Therapeutics Incorporated	PRLD
Organogenesis Holdings Inc.	ORGO
Perpetua Resources Corp.	PPTA
Caribou Biosciences, Inc.	CRBU
OneSpan Inc.	OSPN
Sohu.com Limited	SOHU
Eastman Kodak Company	KODK
Oil States International, Inc.	OIS
Civeo Corporation	CVEO
Willdan Group, Inc.	WLDN
Horizon Technology Finance Corporation	HRZN
Kearny Financial Corp.	KRNY
American Software, Inc.	AMSWA
MasterCraft Boat Holdings, Inc.	MCFT
Forrester Research, Inc.	FORR
Aura Biosciences, Inc.	AURA
OneWater Marine Inc.	ONEW
i-80 Gold Corp.	IAUX
FARO Technologies, Inc.	FARO
Northfield Bancorp, Inc. (Staten Island, NY)	NFBK
ADTRAN Holdings, Inc.	ADTN
Village Super Market, Inc.	VLGEA
Natural Grocers by Vitamin Cottage, Inc.	NGVC
Sonida Senior Living, Inc.	SNDA
Summit Financial Group, Inc.	SMMF
Postal Realty Trust, Inc.	PSTL
AerSale Corporation	ASLE
Carriage Services, Inc.	CSV
Sezzle Inc.	SEZL
Solaris Oilfield Infrastructure, Inc.	SOI
Anika Therapeutics, Inc.	ANIK
Tortoise Energy Infrastructure Corporation	TYG
Esperion Therapeutics, Inc.	ESPR
Arrow Financial Corporation	AROW
Bar Harbor Bankshares	BHB
Forge Global Holdings, Inc.	FRGE
ADC Therapeutics SA	ADCT
America's Car-Mart, Inc.	CRMT
flyExclusive, Inc.	FLYX
Star Group, L.P.	SGU
Monte Rosa Therapeutics, Inc.	GLUE
Rackspace Technology, Inc.	RXT
CVRx, Inc.	CVRX
Galiano Gold Inc.	GAU
Rigel Resource Acquisition Corp.	RRAC
Artesian Resources Corporation	ARTNA
Value Line, Inc.	VALU
Jiayin Group Inc.	JFIN
Porch Group, Inc.	PRCH
Nature's Sunshine Products, Inc.	NATR
Health Catalyst, Inc.	HCAT
PlayAGS, Inc.	AGS
PLAYSTUDIOS, Inc.	MYPS
OppFi Inc.	OPFI
Hingham Institution for Savings	HIFS
Gannett Co., Inc.	GCI
MeiraGTx Holdings plc	MGTX
Precigen, Inc.	PGEN
MMTec, Inc.	MTC
Aquestive Therapeutics, Inc.	AQST
Invivyd, Inc.	IVVD
Tactile Systems Technology, Inc.	TCMD
Greystone Housing Impact Investors LP	GHI
Tenaya Therapeutics, Inc.	TNYA
FibroBiologics, Inc.	FBLG
Enanta Pharmaceuticals, Inc.	ENTA
Limoneira Company	LMNR
Anavex Life Sciences Corp.	AVXL
DMC Global Inc.	BOOM
Novonix Limited	NVX
Q32 Bio Inc.	QTTB
Shore Bancshares, Inc.	SHBI
Medifast, Inc.	MED
ESSA Pharma Inc.	EPIX
Humacyte, Inc.	HUMA
TriplePoint Venture Growth BDC Corp.	TPVG
Net Lease Office Properties	NLOP
China Yuchai International Limited	CYD
TrueBlue, Inc.	TBI
IperionX Limited	IPX
Innovid Corp.	CTV
The RealReal, Inc.	REAL
Himalaya Shipping Ltd.	HSHP
AudioCodes Ltd.	AUDC
DocGo Inc.	DCGO
Renovaro Biosciences Inc.	RENB
Aehr Test Systems	AEHR
TScan Therapeutics, Inc.	TCRX
Community West Bancshares	CWBC
Better Home & Finance Holding Company	BETR
American Vanguard Corporation	AVD
Metagenomi, Inc.	MGX
Matrix Service Company	MTRX
Guaranty Bancshares, Inc.	GNTY
Terns Pharmaceuticals, Inc.	TERN
Applied Digital Corporation	APLD
Clover Health Investments, Corp.	CLOV
Park-Ohio Holdings Corp.	PKOH
Byrna Technologies Inc.	BYRN
Macatawa Bank Corporation	MCBC
Diana Shipping Inc.	DSX
SmartFinancial, Inc.	SMBK
Inflection Point Acquisition Corp. II	IPXX
BRT Apartments Corp.	BRT
ASA Gold and Precious Metals Limited	ASA
SOPHiA GENETICS SA	SOPH
Mid Penn Bancorp, Inc.	MPB
Northwest Pipe Company	NWPX
P.A.M. Transportation Services, Inc.	PTSI
Red River Bancshares, Inc.	RRBI
MidWestOne Financial Group, Inc.	MOFG
Yatsen Holding Limited	YSG
Stellus Capital Investment Corporation	SCM
Hamilton Beach Brands Holding Company	HBB
Flushing Financial Corporation	FFIC
CorMedix Inc.	CRMD
MBIA Inc.	MBI
RAPT Therapeutics, Inc.	RAPT
Erasca, Inc.	ERAS
Gilat Satellite Networks Ltd.	GILT
ModivCare Inc.	MODV
James River Group Holdings, Ltd.	JRVR
Sutro Biopharma, Inc.	STRO
RBB Bancorp	RBB
LexinFintech Holdings Ltd.	LX
Inozyme Pharma, Inc.	INZY
Cerus Corporation	CERS
Gambling.com Group Limited	GAMB
Atea Pharmaceuticals, Inc.	AVIR
Foghorn Therapeutics Inc.	FHTX
Lyra Therapeutics, Inc.	LYRA
Domo, Inc.	DOMO
Codere Online Luxembourg, S.A.	CDRO
Saratoga Investment Corp.	SAR
GreenTree Hospitality Group Ltd.	GHG
New Pacific Metals Corp.	NEWP
Vasta Platform Limited	VSTA
Graham Corporation	GHM
Viemed Healthcare, Inc.	VMD
Ouster, Inc.	OUST
Bridgewater Bancshares, Inc.	BWB
First Bank	FRBA
Pangaea Logistics Solutions, Ltd.	PANL
Investcorp Europe Acquisition Corp I	IVCB
Lincoln Educational Services Corporation	LINC
MicroVision, Inc.	MVIS
AirSculpt Technologies, Inc.	AIRS
Nukkleus Inc.	NUKK
Willis Lease Finance Corporation	WLFC
Fractyl Health, Inc.	GUTS
The Honest Company, Inc.	HNST
AxoGen, Inc.	AXGN
Wetouch Technology Inc.	WETH
Desktop Metal, Inc.	DM
Spok Holdings, Inc.	SPOK
Park Aerospace Corp.	PKE
Potbelly Corporation	PBPB
MYT Netherlands Parent B.V.	MYTE
GEN Restaurant Group, Inc.	GENK
Climb Global Solutions, Inc.	CLMB
Nautilus Biotechnology, Inc.	NAUT
Ispire Technology Inc.	ISPR
Tile Shop Holdings, Inc.	TTSH
Transphorm, Inc.	TGAN
Nektar Therapeutics	NKTR
C3is Inc.	CISS
Akebia Therapeutics, Inc.	AKBA
Newegg Commerce, Inc.	NEGG
WideOpenWest, Inc.	WOW
Pulmonx Corporation	LUNG
Opthea Limited	OPT
Sera Prognostics, Inc.	SERA
Lifeway Foods, Inc.	LWAY
NI Holdings, Inc.	NODK
Procaps Group S.A.	PROC
Wallbox N.V.	WBX
The Lovesac Company	LOVE
XOMA Corporation	XOMA
Materialise NV	MTLS
Genesco Inc.	GCO
HIVE Blockchain Technologies Ltd.	HIVE
Transcontinental Realty Investors, Inc.	TCI
Cooper-Standard Holdings Inc.	CPS
Rayonier Advanced Materials Inc.	RYAM
Park City Group, Inc.	TRAK
Vizsla Silver Corp.	VZLA
Investors Title Company	ITIC
Summit Midstream Partners, LP	SMLP
Terran Orbital Corporation	LLAP
Kamada Ltd.	KMDA
Metalla Royalty & Streaming Ltd.	MTA
Global Water Resources, Inc.	GWRS
Gold Royalty Corp.	GROY
Jaws Mustang Acquisition Corporation	JWSM
AdTheorent Holding Company, Inc.	ADTH
AMMO, Inc.	POWW
Natural Gas Services Group, Inc.	NGS
Uranium Royalty Corp.	UROY
Blade Air Mobility, Inc.	BLDE
Solid Power, Inc.	SLDP
Verrica Pharmaceuticals Inc.	VRCA
ON24, Inc.	ONTF
Allego N.V.	ALLG
United Homes Group, Inc.	UHG
Zumiez Inc.	ZUMZ
ChromaDex Corporation	CDXC
AEON Biopharma, Inc.	AEON
Bioventus Inc.	BVS
Sanara MedTech Inc.	SMTI
SelectQuote, Inc.	SLQT
Sleep Number Corporation	SNBR
Sight Sciences, Inc.	SGHT
8x8, Inc.	EGHT
Turtle Beach Corporation	HEAR
Enterprise Bancorp, Inc.	EBTC
Funko, Inc.	FNKO
Pyxis Oncology, Inc.	PYXS
Verastem, Inc.	VSTM
WhiteHorse Finance, Inc.	WHF
Heritage Insurance Holdings, Inc.	HRTG
Fennec Pharmaceuticals Inc.	FENC
Immutep Limited	IMMP
First Business Financial Services, Inc.	FBIZ
Home Bancorp, Inc.	HBCP
L.B. Foster Company	FSTR
Spire Global, Inc.	SPIR
Ambipar Emergency Response	AMBI
XBiotech Inc.	XBIT
Chicago Atlantic Real Estate Finance, Inc.	REFI
EDAP TMS S.A.	EDAP
Newtek Business Services Corp.	NEWT
Amplify Energy Corp.	AMPY
EVI Industries, Inc.	EVI
TortoiseEcofin Acquisition Corp. III	TRTL
ACNB Corporation	ACNB
GoPro, Inc.	GPRO
Stitch Fix, Inc.	SFIX
Mistras Group, Inc.	MG
J.Jill, Inc.	JILL
Forafric Global PLC	AFRI
Weyco Group, Inc.	WEYS
Traeger, Inc.	COOK
Mayville Engineering Company, Inc.	MEC
Stem, Inc.	STEM
ioneer Ltd	IONR
BigBear.ai Holdings, Inc.	BBAI
Nanobiotix S.A.	NBTX
Angel Oak Mortgage, Inc.	AOMR
El Pollo Loco Holdings, Inc.	LOCO
Farmers & Merchants Bancorp, Inc.	FMAO
Pearl Holdings Acquisition Corp	PRLH
Capital Bancorp, Inc.	CBNK
Ventyx Biosciences, Inc.	VTYX
Luxfer Holdings PLC	LXFR
First Internet Bancorp	INBK
AC Immune SA	ACIU
Arteris, Inc.	AIP
Black Diamond Therapeutics, Inc.	BDTX
Perfect Corp.	PERF
Rani Therapeutics Holdings, Inc.	RANI
The E.W. Scripps Company	SSP
Nathan's Famous, Inc.	NATH
West Bancorporation, Inc.	WTBA
iHeartMedia, Inc.	IHRT
Grindrod Shipping Holdings Ltd.	GRIN
Xeris Biopharma Holdings, Inc.	XERS
Intrepid Potash, Inc.	IPI
Orrstown Financial Services, Inc.	ORRF
Brilliant Earth Group, Inc.	BRLT
TrueCar, Inc.	TRUE
Unity Bancorp, Inc.	UNTY
Telomir Pharmaceuticals, Inc.	TELO
Sharecare, Inc.	SHCR
Superior Group of Companies, Inc.	SGC
The Lion Electric Company	LEV
Actinium Pharmaceuticals, Inc.	ATNM
Telos Corporation	TLS
Carter Bankshares, Inc.	CARE
Sierra Bancorp	BSRR
Adaptimmune Therapeutics plc	ADAP
Poseida Therapeutics, Inc.	PSTX
Peoples Financial Services Corp.	PFIS
Financial Institutions, Inc.	FISI
Southern California Bancorp	BCAL
Ranger Energy Services, Inc.	RNGR
Fidelity D & D Bancorp, Inc.	FDBC
Citizens & Northern Corporation	CZNC
Orion Group Holdings, Inc.	ORN
Dingdong (Cayman) Limited	DDL
Gran Tierra Energy Inc.	GTE
Primis Financial Corp.	FRST
Orange County Bancorp, Inc.	OBT
Red Violet, Inc.	RDVT
VersaBank	VBNK
Hyliion Holdings Corp.	HYLN
Valens Semiconductor Ltd.	VLN
FREYR Battery	FREY
Intuitive Machines, Inc.	LUNR
Western Copper and Gold Corporation	WRN
Industrial Logistics Properties Trust	ILPT
2seventy bio, Inc.	TSVT
Nyxoah S.A.	NYXH
Inovio Pharmaceuticals, Inc.	INO
Rimini Street, Inc.	RMNI
NaaS Technology Inc.	NAAS
Patria Latin American Opportunity Acquisition Corp.	PLAO
Senseonics Holdings, Inc.	SENS
AngioDynamics, Inc.	ANGO
American Realty Investors, Inc.	ARL
Puma Biotechnology, Inc.	PBYI
Bank7 Corp.	BSVN
AVITA Medical, Inc.	RCEL
MVB Financial Corp.	MVBF
Century Therapeutics, Inc.	IPSC
Redwire Corporation	RDW
Lesaka Technologies, Inc.	LSAK
Third Coast Bancshares, Inc.	TCBX
Boundless Bio, Inc.	BOLD
Inspired Entertainment, Inc.	INSE
Cardiff Oncology, Inc.	CRDF
GeneDx Holdings Corp.	WGS
Blink Charging Co.	BLNK
Aldeyra Therapeutics, Inc.	ALDX
Quad/Graphics, Inc.	QUAD
Gencor Industries, Inc.	GENC
Northrim BanCorp, Inc.	NRIM
TriSalus Life Sciences, Inc.	TLSI
Ceragon Networks Ltd.	CRNT
FutureFuel Corp.	FF
Coherus BioSciences, Inc.	CHRS
The First Bancorp, Inc.	FNLC
IBEX Limited	IBEX
JAKKS Pacific, Inc.	JAKK
Euroseas Ltd.	ESEA
Utah Medical Products, Inc.	UTMD
Generation Bio Co.	GBIO
FS Bancorp, Inc.	FSBW
Galectin Therapeutics Inc.	GALT
Spring Valley Acquisition Corp. II	SVII
Piedmont Lithium Inc.	PLL
Lineage Cell Therapeutics, Inc.	LCTX
Companhia Brasileira de Distribuição	CBD
New England Realty Associates LP	NEN
Dakota Gold Corp.	DC
Bank of Marin Bancorp	BMRC
Radiant Logistics, Inc.	RLGT
Regional Management Corp.	RM
Consensus Cloud Solutions, Inc.	CCSI
Adverum Biotechnologies, Inc.	ADVM
Bit Digital, Inc.	BTBT
Sterling Bancorp, Inc. (Southfield, MI)	SBT
Arq, Inc.	ARQ
HomeStreet, Inc.	HMST
San Juan Basin Royalty Trust	SJT
Cartesian Growth Corporation II	RENE
DouYu International Holdings Limited	DOYU
Plum Acquisition Corp. III	PLMJ
Southland Holdings, Inc.	SLND
Quantum-Si incorporated	QSI
Forum Energy Technologies, Inc.	FET
AFC Gamma, Inc.	AFCG
Priority Technology Holdings, Inc.	PRTH
Agora, Inc.	API
G1 Therapeutics, Inc.	GTHX
Vanda Pharmaceuticals Inc.	VNDA
Helix Acquisition Corp. II	HLXB
LINKBANCORP, Inc.	LNKB
Conduit Pharmaceuticals Inc.	CDT
Pioneer Bancorp, Inc.	PBFS
Clarus Corporation	CLAR
Pure Cycle Corporation	PCYO
Datasea Inc.	DTSS
Lanvin Group Holdings Limited	LANV
Kingsway Financial Services Inc.	KFS
Kodiak Sciences Inc.	KOD
Twin Disc, Incorporated	TWIN
PaySign, Inc.	PAYS
Elevation Oncology, Inc.	ELEV
BayCom Corp	BCML
NexPoint Real Estate Finance, Inc.	NREF
Concord Acquisition Corp II	CNDA
Bridger Aerospace Group Holdings, Inc.	BAER
uniQure N.V.	QURE
The First of Long Island Corporation	FLIC
Immersion Corporation	IMMR
Fluent, Inc.	FLNT
CommScope Holding Company, Inc.	COMM
Waterstone Financial, Inc.	WSBF
Solidion Technology Inc.	STI
Sify Technologies Limited	SIFY
Atlas Lithium Corporation	ATLX
Universal Stainless & Alloy Products, Inc.	USAP
Ovid Therapeutics Inc.	OVID
Legato Merger Corp. III	LEGT
Accuray Incorporated	ARAY
Mesabi Trust	MSB
The Aaron's Company, Inc.	AAN
X4 Pharmaceuticals, Inc.	XFOR
Civista Bancshares, Inc.	CIVB
Acumen Pharmaceuticals, Inc.	ABOS
Granite Point Mortgage Trust Inc.	GPMT
Colombier Acquisition Corp.	CLBR
Stereotaxis, Inc.	STXS
Veru Inc.	VERU
Battery Future Acquisition Corp.	BFAC
American Public Education, Inc.	APEI
Tredegar Corporation	TG
Acrivon Therapeutics, Inc.	ACRV
Scilex Holding Company	SCLX
CONX Corp.	CONX
John Marshall Bancorp, Inc.	JMSB
iRobot Corporation	IRBT
Cheche Group Inc	CCG
Five Point Holdings, LLC	FPH
Belpointe PREP, LLC	OZ
Omeros Corporation	OMER
Fanhua Inc.	FANH
PCB Bancorp	PCB
Southern First Bancshares, Inc.	SFST
Lifetime Brands, Inc.	LCUT
Franklin Street Properties Corp.	FSP
EMX Royalty Corporation	EMX
Citizens Financial Services, Inc.	CZFS
23andMe Holding Co.	ME
SWK Holdings Corporation	SWKH
Merrimack Pharmaceuticals, Inc.	MACK
Commercial Vehicle Group, Inc.	CVGI
bluebird bio, Inc.	BLUE
Maiden Holdings, Ltd.	MHLD
Northeast Community Bancorp, Inc.	NECB
NACCO Industries, Inc.	NC
Rigel Pharmaceuticals, Inc.	RIGL
Canaan Inc.	CAN
RCF Acquisition Corp.	RCFA
Alico, Inc.	ALCO
Smith-Midland Corporation	SMID
StealthGas Inc.	GASS
Zevra Therapeutics, Inc.	ZVRA
EZGO Technologies Ltd.	EZGO
Atossa Therapeutics, Inc.	ATOS
Southern States Bancshares, Inc.	SSBK
Alpine Income Property Trust, Inc.	PINE
Whole Earth Brands, Inc.	FREE
Plumas Bancorp	PLBC
1stdibs.Com, Inc.	DIBS
Design Therapeutics, Inc.	DSGN
Blue Foundry Bancorp	BLFY
Abeona Therapeutics Inc.	ABEO
Compass Therapeutics, Inc.	CMPX
USCB Financial Holdings, Inc.	USCB
Codorus Valley Bancorp, Inc.	CVLY
Caledonia Mining Corporation Plc	CMCL
Ellomay Capital Ltd.	ELLO
CPI Card Group Inc.	PMTS
Murano Global Investments PLC	MRNO
Standard Lithium Ltd.	SLI
Enphys Acquisition Corp.	NFYS
Keen Vision Acquisition Corporation	KVAC
Akoya Biosciences, Inc.	AKYA
RGC Resources, Inc.	RGCO
Townsquare Media, Inc.	TSQ
Lucas GC Limited	LGCL
Gores Holdings IX, Inc.	GHIX
Timberland Bancorp, Inc.	TSBK
Gossamer Bio, Inc.	GOSS
QuantaSing Group Ltd	QSG
Codexis, Inc.	CDXS
Nouveau Monde Graphite Inc.	NMG
Iteris, Inc.	ITI
Contango Ore, Inc.	CTGO
Trevi Therapeutics, Inc.	TRVI
Magnachip Semiconductor Corporation	MX
Greenwich LifeSciences, Inc.	GLSI
Outbrain Inc.	OB
Innate Pharma S.A.	IPHA
Werewolf Therapeutics, Inc.	HOWL
908 Devices Inc.	MASS
The Eastern Company	EML
SDCL EDGE Acquisition Corporation	SEDA
Offerpad Solutions Inc.	OPAD
Osisko Development Corp.	ODV
Innoviz Technologies Ltd.	INVZ
Everest Consolidator Acquisition Corporation	MNTN
RumbleON, Inc.	RMBL
Capricor Therapeutics, Inc.	CAPR
Tucows Inc.	TCX
Rocky Brands, Inc.	RCKY
Alpha Tau Medical Ltd.	DRTS
Hooker Furnishings Corporation	HOFT
Citi Trends, Inc.	CTRN
Flexsteel Industries, Inc.	FLXS
Vera Bradley, Inc.	VRA
Candel Therapeutics, Inc.	CADL
System1, Inc.	SST
Ooma, Inc.	OOMA
OptimizeRx Corporation	OPRX
BARK, Inc.	BARK
Virco Mfg. Corporation	VIRC
Semler Scientific, Inc.	SMLR
Cango Inc.	CANG
eGain Corporation	EGAN
Profound Medical Corp.	PROF
Cellectis S.A.	CLLS
Consumer Portfolio Services, Inc.	CPSS
Parke Bancorp, Inc.	PKBK
Evolution Petroleum Corporation	EPM
Norwood Financial Corp.	NWFL
Lotus Technology Inc.	LOT
Oak Valley Bancorp	OVLY
Mondee Holdings, Inc.	MOND
Ponce Financial Group, Inc.	PDLB
Bankwell Financial Group, Inc.	BWFG
NN, Inc.	NNBR
Oxford Square Capital Corp.	OXSQ
Digital Turbine, Inc.	APPS
Compugen Ltd.	CGEN
D-Wave Quantum Inc.	QBTS
Destination XL Group, Inc.	DXLG
BlackSky Technology Inc.	BKSY
Seven Hills Realty Trust	SEVN
SoundThinking Inc	SSTI
Kaltura, Inc.	KLTR
Aeva Technologies, Inc.	AEVA
QuickLogic Corporation	QUIK
Performant Financial Corporation	PFMT
Outlook Therapeutics, Inc.	OTLK
Chemung Financial Corporation	CHMG
INmune Bio, Inc.	INMB
First Financial Northwest, Inc.	FFNW
Rigetti Computing, Inc.	RGTI
Asure Software, Inc.	ASUR
Princeton Bancorp Inc	BPRN
Inventiva S.A.	IVA
Caesarstone Ltd.	CSTE
Augmedix, Inc.	AUGX
Colony Bankcorp, Inc.	CBAN
Northern Dynasty Minerals Ltd.	NAK
Butterfly Network, Inc.	BFLY
Lifecore Biomedical, Inc.	LFCR
Adlai Nortye Ltd.	ANL
Project Energy Reimagined Acquisition Corp.	PEGR
P3 Health Partners Inc.	PIII
LCNB Corp.	LCNB
Entravision Communications Corporation	EVC
Alimera Sciences, Inc.	ALIM
Harvard Bioscience, Inc.	HBIO
Regulus Therapeutics Inc.	RGLS
California BanCorp	CALB
Investcorp India Acquisition Corp	IVCA
Kandi Technologies Group, Inc.	KNDI
OrganiGram Holdings Inc.	OGI
FVCBankcorp, Inc.	FVCB
PrimeEnergy Resources Corporation	PNRG
Quest Resource Holding Corporation	QRHC
LENZ Therapeutics, Inc.	LENZ
Innodata Inc.	INOD
X3 Holdings Co Ltd.	XTKG
Airship AI Holdings, Inc.	AISP
ThredUp Inc.	TDUP
Medallion Financial Corp.	MFIN
Vertical Aerospace Ltd.	EVTL
Ocwen Financial Corporation	OCN
SilverBox Corp III	SBXC
HireQuest, Inc.	HQI
City Office REIT, Inc.	CIO
Veritone, Inc.	VERI
Tristar Acquisition I Corp.	TRIS
Portman Ridge Finance Corporation	PTMN
Purple Innovation, Inc.	PRPL
Stratus Properties Inc.	STRS
The Joint Corp.	JYNT
Middlefield Banc Corp.	MBCN
Escalade, Incorporated	ESCA
Eos Energy Enterprises, Inc.	EOSE
VOXX International Corporation	VOXX
Full House Resorts, Inc.	FLL
Information Services Group, Inc.	III
Mama's Creations, Inc.	MAMA
Genfit S.A.	GNFT
ProQR Therapeutics N.V.	PRQR
scPharmaceuticals Inc.	SCPH
Adicet Bio, Inc.	ACET
AP Acquisition Corp.	APCA
KNOT Offshore Partners LP	KNOP
Kopin Corporation	KOPN
Orion Office REIT Inc.	ONL
Tilly's, Inc.	TLYS
Orchestra BioMed Holdings, Inc.	OBIO
Geospace Technologies Corporation	GEOS
Hennessy Capital Investment Corp. VI	HCVI
Ames National Corporation	ATLO
TH International Limited	THCH
Rekor Systems, Inc.	REKR
Inogen, Inc.	INGN
EVe Mobility Acquisition Corp	EVE
National Bankshares, Inc.	NKSH
Seanergy Maritime Holdings Corp.	SHIP
Agenus Inc.	AGEN
The ONE Group Hospitality, Inc.	STKS
InfuSystem Holdings, Inc.	INFU
High Tide Inc.	HITI
Brand Engagement Network, Inc.	BNAI
Aemetis, Inc.	AMTX
SK Growth Opportunities Corporation	SKGR
Energy Vault Holdings, Inc.	NRGV
Spark I Acquisition Corp. Class A Ordinary Share	SPKL
Vericity, Inc.	VERY
Generation Asia I Acquisition Limited	GAQ
CSP Inc.	CSPI
ChoiceOne Financial Services, Inc.	COFS
GoldMining Inc.	GLDG
Burtech Acquisition Corp.	BRKH
American Well Corporation	AMWL
Amprius Technologies, Inc.	AMPX
AG Mortgage Investment Trust, Inc.	MITT
BCB Bancorp, Inc.	BCBP
DLH Holdings Corp.	DLHC
Learn CW Investment Corporation	LCW
Hallador Energy Company	HNRG
HF Foods Group Inc.	HFFG
Everspin Technologies, Inc.	MRAM
Perma-Fix Environmental Services, Inc.	PESI
Microvast Holdings, Inc.	MVST
Braemar Hotels & Resorts Inc.	BHR
ESSA Bancorp, Inc.	ESSA
Mountain & Co. I Acquisition Corp.	MCAA
Atomera Incorporated	ATOM
FiscalNote Holdings, Inc.	NOTE
Vast Renewables Limited	VSTE
Star Holdings	STHO
YS Biopharma Co., Ltd.	YS
FingerMotion, Inc.	FNGR
Quipt Home Medical Corp.	QIPT
AudioEye, Inc.	AEYE
Cybin Inc.	CYBN
Sangoma Technologies Corporation	SANG
374Water, Inc.	SCWO
LiveOne, Inc.	LVO
Security National Financial Corporation	SNFCA
ASP Isotopes Inc.	ASPI
Hyzon Motors Inc.	HYZN
Mynd.ai, Inc.	MYND
Core Molding Technologies, Inc.	CMT
Alchemy Investments Acquisition Corp 1	ALCY
Pyrophyte Acquisition Corp.	PHYT
MSP Recovery, Inc.	LIFW
Bakkt Holdings, Inc.	BKKT
Vaxart, Inc.	VXRT
SolarBank Corporation	SUUN
Mammoth Energy Services, Inc.	TUSK
ClearPoint Neuro, Inc.	CLPT
Alto Ingredients, Inc.	ALTO
Cadiz Inc.	CDZI
Niu Technologies	NIU
Haoxi Health Technology Limited	HAO
CervoMed Inc.	CRVO
Acme United Corporation	ACU
GlycoMimetics, Inc.	GLYC
RCM Technologies, Inc.	RCMT
Smart Share Global Limited	EM
Canoo Inc.	GOEV
Monroe Capital Corporation	MRCC
Sagimet Biosciences Inc.	SGMT
Repare Therapeutics Inc.	RPTX
Inotiv, Inc.	NOTV
Vacasa, Inc.	VCSA
Investar Holding Corporation	ISTR
Li-Cycle Holdings Corp.	LICY
Massimo Group	MAMO
Duluth Holdings Inc.	DLTH
Gevo, Inc.	GEVO
Sachem Capital Corp.	SACH
Solowin Holdings Ordinary Share	SWIN
InFinT Acquisition Corporation	IFIN
ESH Acquisition Corp.	ESHA
FTAC Emerald Acquisition Corp.	EMLD
MediWound Ltd.	MDWD
X Financial	XYF
Peoples Bancorp of North Carolina, Inc.	PEBK
BioAtla, Inc.	BCAB
I-Mab	IMAB
Arrowroot Acquisition Corp.	ARRW
International Tower Hill Mines Ltd.	THM
AXT, Inc.	AXTI
Blockchain Coinvestors Acquisition Corp. I	BCSA
Shengfeng Development Limited	SFWL
First United Corporation	FUNC
Evans Bancorp, Inc.	EVBN
Hawthorn Bancshares, Inc.	HWBK
Achieve Life Sciences, Inc.	ACHV
Arbe Robotics Ltd.	ARBE
Captivision Inc.	CAPT
Alarum Technologies Ltd.	ALAR
Omega Therapeutics, Inc.	OMGA
Ultralife Corporation	ULBI
inTEST Corporation	INTT
Zura Bio Limited	ZURA
GrowGeneration Corp.	GRWG
CytomX Therapeutics, Inc.	CTMX
American Lithium Corp.	AMLI
Viant Technology Inc.	DSP
10X Capital Venture Acquisition Corp. III	VCXB
Modiv Inc.	MDV
IB Acquisition Corp.	IBAC
Syros Pharmaceuticals, Inc.	SYRS
WW International, Inc.	WW
Amylyx Pharmaceuticals, Inc.	AMLX
Taylor Devices, Inc.	TAYD
RADCOM Ltd.	RDCM
ZeroFox Holdings, Inc.	ZFOX
eHealth, Inc.	EHTH
Biodesix, Inc.	BDSX
Provident Bancorp, Inc.	PVBC
Karyopharm Therapeutics Inc.	KPTI
Relmada Therapeutics, Inc.	RLMD
Silvercrest Asset Management Group Inc.	SAMG
Village Farms International, Inc.	VFF
Israel Acquisitions Corp	ISRL
Prairie Operating Co.	PROP
Twelve Seas Investment Company II	TWLV
Empire Petroleum Corporation	EP
Virginia National Bankshares Corporation	VABK
Alpha Star Acquisition Corporation	ALSA
Western New England Bancorp, Inc.	WNEB
Richardson Electronics, Ltd.	RELL
RE/MAX Holdings, Inc.	RMAX
OptiNose, Inc.	OPTN
Bragg Gaming Group Inc.	BRAG
Drilling Tools International Corp.	DTI
VirTra, Inc.	VTSI
Satellogic Inc.	SATL
Athena Technology Acquisition Corp. II	ATEK
OP Bancorp	OPBK
C&F Financial Corporation	CFFI
Friedman Industries, Incorporated	FRD
Penns Woods Bancorp, Inc.	PWOD
OPAL Fuels Inc.	OPAL
Valuence Merger Corp. I	VMCA
DBV Technologies S.A.	DBVT
Saga Communications, Inc.	SGA
G. Willi-Food International Ltd.	WILC
Markforged Holding Corporation	MKFG
ArrowMark Financial Corp.	BANX
TLGY Acquisition Corporation	TLGY
Zomedica Corp.	ZOM
VistaGen Therapeutics, Inc.	VTGN
Loop Industries, Inc.	LOOP
Platinum Group Metals Ltd.	PLG
Coya Therapeutics, Inc.	COYA
Ellington Residential Mortgage REIT	EARN
Direct Digital Holdings, Inc.	DRCT
Northern Technologies International Corporation	NTIC
Skillz Inc.	SKLZ
First Western Financial, Inc.	MYFW
Global Partner Acquisition Corp II	GPAC
Zalatoris II Acquisition Corp.	ZLS
99 Acquisition Group Inc.	NNAG
Molecular Partners AG	MOLN
FitLife Brands, Inc.	FTLF
Vor Biopharma Inc.	VOR
Immunic, Inc.	IMUX
OFS Capital Corporation	OFS
Universal Electronics Inc.	UEIC
Douglas Elliman Inc.	DOUG
AstroNova, Inc.	ALOT
Neuronetics, Inc.	STIM
FibroGen, Inc.	FGEN
BankFinancial Corporation	BFIN
PSQ Holdings, Inc.	PSQH
MainStreet Bancshares, Inc.	MNSB
Annovis Bio, Inc.	ANVS
TruBridge, Inc.	TBRG
Pinstripes Holdings Inc.	PNST
KLX Energy Services Holdings, Inc.	KLXE
United Security Bancshares	UBFO
CNFinance Holdings Limited	CNF
RMG Acquisition Corp. III	RMGC
Direct Selling Acquisition Corp.	DSAQ
Focus Impact Acquisition Corp.	FIAC
Planet Image International Limited	YIBO
Xiao-I Corporation	AIXI
First Guaranty Bancshares, Inc.	FGBI
U-BX Technology Ltd.	UBXG
Citius Pharmaceuticals, Inc.	CTXR
Hurco Companies, Inc.	HURC
Electromed, Inc.	ELMD
First Community Corporation	FCCO
Plum Acquisition Corp. I	PLMI
Papaya Growth Opportunity Corp. I	PPYA
Nuvectis Pharma, Inc.	NVCT
Kensington Capital Acquisition Corp. V	KCGI
Richmond Mutual Bancorporation, Inc.	RMBI
Marblegate Acquisition Corp.	GATE
Lument Finance Trust, Inc.	LFT
New Providence Acquisition Corp. II	NPAB
TAT Technologies Ltd.	TATT
Sportsman's Warehouse Holdings, Inc.	SPWH
Union Bankshares, Inc.	UNB
Lantronix, Inc.	LTRX
Syntec Optics Holdings, Inc.	OPTX
Lakeland Industries, Inc.	LAKE
PHX Minerals Inc.	PHX
a.k.a. Brands Holding Corp.	AKA
TPI Composites, Inc.	TPIC
Sunlands Technology Group	STG
So-Young International Inc.	SY
Energy Services of America Corporation	ESOA
Motorcar Parts of America, Inc.	MPAA
FinWise Bancorp	FINW
ContextLogic Inc.	WISH
Expensify, Inc.	EXFY
Delcath Systems, Inc.	DCTH
Cheetah Mobile Inc.	CMCM
Bassett Furniture Industries, Incorporated	BSET
Barinthus Biotherapeutics plc	BRNS
TELA Bio, Inc.	TELA
Emeren Group Ltd	SOL
Travelzoo	TZOO
Cardiol Therapeutics Inc.	CRDL
Blue Ocean Acquisition Corp.	BOCN
Westwood Holdings Group, Inc.	WHG
Crexendo, Inc.	CXDO
Kolibri Global Energy Inc.	KGEI
The L.S. Starrett Company	SCX
Zentek Ltd.	ZTEK
ECB Bancorp, Inc.	ECBK
Brooge Energy Limited	BROG
Eliem Therapeutics, Inc.	ELYM
Seer, Inc.	SEER
TROOPS, Inc.	TROO
Vigil Neuroscience, Inc.	VIGL
Identiv, Inc.	INVE
Epsilon Energy Ltd.	EPSN
FAT Brands Inc.	FAT
CF Bankshares Inc.	CFBK
Corner Growth Acquisition Corp.	COOL
aTyr Pharma, Inc.	LIFE
ProPhase Labs, Inc.	PRPH
Freightos Limited	CRGO
Innovative Solutions and Support, Inc.	ISSC
Armata Pharmaceuticals, Inc.	ARMP
PDS Biotechnology Corporation	PDSB
William Penn Bancorporation	WMPN
Cantaloupe, Inc.	CTLP
Biomea Fusion, Inc.	BMEA
Mersana Therapeutics, Inc.	MRSN
National CineMedia, Inc.	NCMI
SkyWater Technology, Inc.	SKYT
Voyager Therapeutics, Inc.	VYGR
Southern Missouri Bancorp, Inc.	SMBC
Spirit Airlines, Inc.	SAVE
Xperi Holding Corporation	XPER
Greene County Bancorp, Inc.	GCBC
PowerFleet, Inc.	PWFL
The Beauty Health Company	SKIN
Farmers National Banc Corp.	FMNB
American Superconductor Corporation	AMSC
Aveanna Healthcare Holdings Inc.	AVAH
Jumia Technologies AG	JMIA
Lilium N.V.	LILM
Hanmi Financial Corporation	HAFC
biote Corp.	BTMD
Harrow Health, Inc.	HROW
Five Star Bancorp	FSBC
Xponential Fitness, Inc.	XPOF
Clearfield, Inc.	CLFD
GDEV Inc.	GDEV
PennantPark Investment Corporation	PNNT
Larimar Therapeutics, Inc.	LRMR
Shattuck Labs, Inc.	STTK
Methode Electronics, Inc.	MEI
Donegal Group Inc.	DGICA
Vishay Precision Group, Inc.	VPG
Gladstone Capital Corporation	GLAD
CareDx, Inc	CDNA
Capital City Bank Group, Inc.	CCBG
Global Indemnity Group, LLC	GBLI
Donegal Group Inc.	DGICB
Agriculture & Natural Solutions Acquisition Corporation	ANSC
Limbach Holdings, Inc.	LMB
Yiren Digital Ltd.	YRD
Denny's Corporation	DENN
Stoneridge, Inc.	SRI
Ocugen, Inc.	OCGN
Slam Corp.	SLAM
Replimune Group, Inc.	REPL
Oculis Holding AG	OCS
Daktronics, Inc.	DAKT
Heron Therapeutics, Inc.	HRTX
Cementos Pacasmayo S.A.A.	CPAC
Johnson Outdoors Inc.	JOUT
Adaptive Biotechnologies Corporation	ADPT
Greenfire Resources Ltd	GFR
NETGEAR, Inc.	NTGR
SunPower Corporation	SPWR
Entrada Therapeutics, Inc.	TRDA
Calavo Growers, Inc.	CVGW
fuboTV Inc.	FUBO
Diamond Hill Investment Group, Inc.	DHIL
Virgin Galactic Holdings, Inc.	SPCE
Aris Water Solutions, Inc.	ARIS
Aviat Networks, Inc.	AVNW
Applied Optoelectronics, Inc.	AAOI
ZimVie Inc.	ZIMV
Orchid Island Capital, Inc.	ORC
Revance Therapeutics, Inc.	RVNC
Beyond Meat, Inc.	BYND
Corbus Pharmaceuticals Holdings, Inc.	CRBP
Greenlight Capital Re, Ltd.	GLRE
Valhi, Inc.	VHI
HarborOne Bancorp, Inc.	HONE
Camden National Corporation	CAC
Cibus, Inc.	CBUS
Landsea Homes Corporation	LSEA
Avid Bioservices, Inc.	CDMO
LSI Industries Inc.	LYTS
Washington Trust Bancorp, Inc.	WASH
Dave Inc.	DAVE
Overseas Shipholding Group, Inc.	OSG
Green Dot Corporation	GDOT
First Financial Corporation	THFF
HomeTrust Bancshares, Inc.	HTBI
ATN International, Inc.	ATNI
PepGen Inc.	PEPG
NuScale Power Corporation	SMR
iTeos Therapeutics, Inc.	ITOS
Genie Energy Ltd.	GNE
Jasper Therapeutics, Inc.	JSPR
Lindblad Expeditions Holdings, Inc.	LIND
MaxCyte, Inc.	MXCT
Ring Energy, Inc.	REI
Marinus Pharmaceuticals, Inc.	MRNS
Invesco Mortgage Capital Inc.	IVR
Community Health Systems, Inc.	CYH
Seneca Foods Corporation	SENEB
Peapack-Gladstone Financial Corporation	PGC
Mereo BioPharma Group plc	MREO
Skeena Resources Limited	SKE
The Marcus Corporation	MCS
CompX International Inc.	CIX
OraSure Technologies, Inc.	OSUR
Tejon Ranch Co.	TRC
CNB Financial Corporation	CCNE
South Plains Financial, Inc.	SPFI
Alta Equipment Group Inc.	ALTG
VNET Group, Inc.	VNET
Lands' End, Inc.	LE
Groupon, Inc.	GRPN
Northeast Bank	NBN
Tevogen Bio Holdings Inc.	TVGN
Lexeo Therapeutics, Inc.	LXEO
ProKidney Corp.	PROK
NVE Corporation	NVEC
SOS Limited	SOS
Excelerate Energy, Inc.	EE
Roadzen, Inc.	RDZN
ATRenew Inc.	RERE
Nabors Energy Transition Corp. II	NETD
Atlanticus Holdings Corporation	ATLC
Pulse Biosciences, Inc.	PLSE
Build-A-Bear Workshop, Inc.	BBW
Latham Group, Inc.	SWIM
Seneca Foods Corporation	SENEA
Nexxen International Ltd.	NEXN
The Shyft Group, Inc.	SHYF
Zhihu Inc.	ZH
Alerus Financial Corporation	ALRS
Movado Group, Inc.	MOV
Gogoro Inc.	GGR
Resources Connection, Inc.	RGP
Emerald Holding, Inc.	EEX
Concrete Pumping Holdings, Inc.	BBCP
Solid Biosciences Inc.	SLDB
Tellurian Inc.	TELL
Amarin Corporation plc	AMRN
L Catterton Asia Acquisition Corp	LCAA
Backblaze, Inc.	BLZE
Burke & Herbert Bank & Trust Company	BHRB
LifeMD, Inc.	LFMD
TTEC Holdings, Inc.	TTEC
Consolidated Water Co. Ltd.	CWCO
Oppenheimer Holdings Inc.	OPY
First Foundation Inc.	FFWM
Contineum Therapeutics, Inc.	CTNM
NL Industries, Inc.	NL
Qurate Retail, Inc.	QRTEA
Maui Land & Pineapple Company, Inc.	MLP
CTO Realty Growth, Inc.	CTO
Surmodics, Inc.	SRDX
Marine Products Corporation	MPX
Unisys Corporation	UIS
Alto Neuroscience, Inc.	ANRO
Zynex, Inc.	ZYXI
NeuroPace, Inc.	NPCE
Metropolitan Bank Holding Corp.	MCB
Qurate Retail, Inc.	QRTEB
Ares Commercial Real Estate Corporation	ACRE
Atai Life Sciences N.V.	ATAI
W&T Offshore, Inc.	WTI
Esquire Financial Holdings, Inc.	ESQ
Prelude Therapeutics Incorporated	PRLD
Organogenesis Holdings Inc.	ORGO
Perpetua Resources Corp.	PPTA
Caribou Biosciences, Inc.	CRBU
OneSpan Inc.	OSPN
Sohu.com Limited	SOHU
Eastman Kodak Company	KODK
Oil States International, Inc.	OIS
Civeo Corporation	CVEO
Willdan Group, Inc.	WLDN
Horizon Technology Finance Corporation	HRZN
Kearny Financial Corp.	KRNY
American Software, Inc.	AMSWA
MasterCraft Boat Holdings, Inc.	MCFT
Forrester Research, Inc.	FORR
Aura Biosciences, Inc.	AURA
OneWater Marine Inc.	ONEW
i-80 Gold Corp.	IAUX
FARO Technologies, Inc.	FARO
Northfield Bancorp, Inc. (Staten Island, NY)	NFBK
ADTRAN Holdings, Inc.	ADTN
Village Super Market, Inc.	VLGEA
Natural Grocers by Vitamin Cottage, Inc.	NGVC
Sonida Senior Living, Inc.	SNDA
Summit Financial Group, Inc.	SMMF
Postal Realty Trust, Inc.	PSTL
AerSale Corporation	ASLE
Carriage Services, Inc.	CSV
Sezzle Inc.	SEZL
Solaris Oilfield Infrastructure, Inc.	SOI
Anika Therapeutics, Inc.	ANIK
Tortoise Energy Infrastructure Corporation	TYG
Esperion Therapeutics, Inc.	ESPR
Arrow Financial Corporation	AROW
Bar Harbor Bankshares	BHB
Forge Global Holdings, Inc.	FRGE
ADC Therapeutics SA	ADCT
America's Car-Mart, Inc.	CRMT
flyExclusive, Inc.	FLYX
Star Group, L.P.	SGU
Monte Rosa Therapeutics, Inc.	GLUE
Rackspace Technology, Inc.	RXT
CVRx, Inc.	CVRX
Galiano Gold Inc.	GAU
Rigel Resource Acquisition Corp.	RRAC
Artesian Resources Corporation	ARTNA
Value Line, Inc.	VALU
Jiayin Group Inc.	JFIN
Porch Group, Inc.	PRCH
Nature's Sunshine Products, Inc.	NATR
Health Catalyst, Inc.	HCAT
PlayAGS, Inc.	AGS
PLAYSTUDIOS, Inc.	MYPS
OppFi Inc.	OPFI
Hingham Institution for Savings	HIFS
Gannett Co., Inc.	GCI
MeiraGTx Holdings plc	MGTX
Precigen, Inc.	PGEN
MMTec, Inc.	MTC
Aquestive Therapeutics, Inc.	AQST
Invivyd, Inc.	IVVD
Tactile Systems Technology, Inc.	TCMD
Greystone Housing Impact Investors LP	GHI
Tenaya Therapeutics, Inc.	TNYA
FibroBiologics, Inc.	FBLG
Enanta Pharmaceuticals, Inc.	ENTA
Limoneira Company	LMNR
Anavex Life Sciences Corp.	AVXL
DMC Global Inc.	BOOM
Novonix Limited	NVX
Q32 Bio Inc.	QTTB
Shore Bancshares, Inc.	SHBI
Medifast, Inc.	MED
ESSA Pharma Inc.	EPIX
Humacyte, Inc.	HUMA
TriplePoint Venture Growth BDC Corp.	TPVG
Net Lease Office Properties	NLOP
China Yuchai International Limited	CYD
TrueBlue, Inc.	TBI
IperionX Limited	IPX
Innovid Corp.	CTV
The RealReal, Inc.	REAL
Himalaya Shipping Ltd.	HSHP
AudioCodes Ltd.	AUDC
DocGo Inc.	DCGO
Renovaro Biosciences Inc.	RENB
Aehr Test Systems	AEHR
TScan Therapeutics, Inc.	TCRX
Community West Bancshares	CWBC
Better Home & Finance Holding Company	BETR
American Vanguard Corporation	AVD
Metagenomi, Inc.	MGX
Matrix Service Company	MTRX
Guaranty Bancshares, Inc.	GNTY
Terns Pharmaceuticals, Inc.	TERN
Applied Digital Corporation	APLD
Clover Health Investments, Corp.	CLOV
Park-Ohio Holdings Corp.	PKOH
Byrna Technologies Inc.	BYRN
Macatawa Bank Corporation	MCBC
Diana Shipping Inc.	DSX
SmartFinancial, Inc.	SMBK
Inflection Point Acquisition Corp. II	IPXX
BRT Apartments Corp.	BRT
ASA Gold and Precious Metals Limited	ASA
SOPHiA GENETICS SA	SOPH
Mid Penn Bancorp, Inc.	MPB
Northwest Pipe Company	NWPX
P.A.M. Transportation Services, Inc.	PTSI
Red River Bancshares, Inc.	RRBI
MidWestOne Financial Group, Inc.	MOFG
Yatsen Holding Limited	YSG
Stellus Capital Investment Corporation	SCM
Hamilton Beach Brands Holding Company	HBB
Flushing Financial Corporation	FFIC
CorMedix Inc.	CRMD
MBIA Inc.	MBI
RAPT Therapeutics, Inc.	RAPT
Erasca, Inc.	ERAS
Gilat Satellite Networks Ltd.	GILT
ModivCare Inc.	MODV
James River Group Holdings, Ltd.	JRVR
Sutro Biopharma, Inc.	STRO
RBB Bancorp	RBB
LexinFintech Holdings Ltd.	LX
Inozyme Pharma, Inc.	INZY
Cerus Corporation	CERS
Gambling.com Group Limited	GAMB
Atea Pharmaceuticals, Inc.	AVIR
Foghorn Therapeutics Inc.	FHTX
Lyra Therapeutics, Inc.	LYRA
Domo, Inc.	DOMO
Codere Online Luxembourg, S.A.	CDRO
Saratoga Investment Corp.	SAR
GreenTree Hospitality Group Ltd.	GHG
New Pacific Metals Corp.	NEWP
Vasta Platform Limited	VSTA
Graham Corporation	GHM
Viemed Healthcare, Inc.	VMD
Ouster, Inc.	OUST
Bridgewater Bancshares, Inc.	BWB
First Bank	FRBA
Pangaea Logistics Solutions, Ltd.	PANL
Investcorp Europe Acquisition Corp I	IVCB
Lincoln Educational Services Corporation	LINC
MicroVision, Inc.	MVIS
AirSculpt Technologies, Inc.	AIRS
Nukkleus Inc.	NUKK
Willis Lease Finance Corporation	WLFC
Fractyl Health, Inc.	GUTS
The Honest Company, Inc.	HNST
AxoGen, Inc.	AXGN
Wetouch Technology Inc.	WETH
Desktop Metal, Inc.	DM
Spok Holdings, Inc.	SPOK
Park Aerospace Corp.	PKE
Potbelly Corporation	PBPB
MYT Netherlands Parent B.V.	MYTE
GEN Restaurant Group, Inc.	GENK
Climb Global Solutions, Inc.	CLMB
Nautilus Biotechnology, Inc.	NAUT
Ispire Technology Inc.	ISPR
Tile Shop Holdings, Inc.	TTSH
Transphorm, Inc.	TGAN
Nektar Therapeutics	NKTR
C3is Inc.	CISS
Akebia Therapeutics, Inc.	AKBA
Newegg Commerce, Inc.	NEGG
WideOpenWest, Inc.	WOW
Pulmonx Corporation	LUNG
Opthea Limited	OPT
Sera Prognostics, Inc.	SERA
Lifeway Foods, Inc.	LWAY
NI Holdings, Inc.	NODK
Procaps Group S.A.	PROC
Wallbox N.V.	WBX
The Lovesac Company	LOVE
XOMA Corporation	XOMA
Materialise NV	MTLS
Genesco Inc.	GCO
HIVE Blockchain Technologies Ltd.	HIVE
Transcontinental Realty Investors, Inc.	TCI
Cooper-Standard Holdings Inc.	CPS
Rayonier Advanced Materials Inc.	RYAM
Park City Group, Inc.	TRAK
Vizsla Silver Corp.	VZLA
Investors Title Company	ITIC
Summit Midstream Partners, LP	SMLP
Terran Orbital Corporation	LLAP
Kamada Ltd.	KMDA
Metalla Royalty & Streaming Ltd.	MTA
Global Water Resources, Inc.	GWRS
Gold Royalty Corp.	GROY
Jaws Mustang Acquisition Corporation	JWSM
AdTheorent Holding Company, Inc.	ADTH
AMMO, Inc.	POWW
Natural Gas Services Group, Inc.	NGS
Uranium Royalty Corp.	UROY
Blade Air Mobility, Inc.	BLDE
Solid Power, Inc.	SLDP
Verrica Pharmaceuticals Inc.	VRCA
ON24, Inc.	ONTF
Allego N.V.	ALLG
United Homes Group, Inc.	UHG
Zumiez Inc.	ZUMZ
ChromaDex Corporation	CDXC
AEON Biopharma, Inc.	AEON
Bioventus Inc.	BVS
Sanara MedTech Inc.	SMTI
SelectQuote, Inc.	SLQT
Sleep Number Corporation	SNBR
Sight Sciences, Inc.	SGHT
8x8, Inc.	EGHT
Turtle Beach Corporation	HEAR
Enterprise Bancorp, Inc.	EBTC
Funko, Inc.	FNKO
Pyxis Oncology, Inc.	PYXS
Verastem, Inc.	VSTM
WhiteHorse Finance, Inc.	WHF
Heritage Insurance Holdings, Inc.	HRTG
Fennec Pharmaceuticals Inc.	FENC
Immutep Limited	IMMP
First Business Financial Services, Inc.	FBIZ
Home Bancorp, Inc.	HBCP
L.B. Foster Company	FSTR
Spire Global, Inc.	SPIR
Ambipar Emergency Response	AMBI
XBiotech Inc.	XBIT
Chicago Atlantic Real Estate Finance, Inc.	REFI
EDAP TMS S.A.	EDAP
Newtek Business Services Corp.	NEWT
Amplify Energy Corp.	AMPY
EVI Industries, Inc.	EVI
TortoiseEcofin Acquisition Corp. III	TRTL
ACNB Corporation	ACNB
GoPro, Inc.	GPRO
Stitch Fix, Inc.	SFIX
Mistras Group, Inc.	MG
J.Jill, Inc.	JILL
Forafric Global PLC	AFRI
Weyco Group, Inc.	WEYS
Traeger, Inc.	COOK
Mayville Engineering Company, Inc.	MEC
Stem, Inc.	STEM
ioneer Ltd	IONR
BigBear.ai Holdings, Inc.	BBAI
Nanobiotix S.A.	NBTX
Angel Oak Mortgage, Inc.	AOMR
El Pollo Loco Holdings, Inc.	LOCO
Farmers & Merchants Bancorp, Inc.	FMAO
Pearl Holdings Acquisition Corp	PRLH
Capital Bancorp, Inc.	CBNK
Ventyx Biosciences, Inc.	VTYX
Luxfer Holdings PLC	LXFR
First Internet Bancorp	INBK
AC Immune SA	ACIU
Arteris, Inc.	AIP
Black Diamond Therapeutics, Inc.	BDTX
Perfect Corp.	PERF
Rani Therapeutics Holdings, Inc.	RANI
The E.W. Scripps Company	SSP
Nathan's Famous, Inc.	NATH
West Bancorporation, Inc.	WTBA
iHeartMedia, Inc.	IHRT
Grindrod Shipping Holdings Ltd.	GRIN
Xeris Biopharma Holdings, Inc.	XERS
Intrepid Potash, Inc.	IPI
Orrstown Financial Services, Inc.	ORRF
Brilliant Earth Group, Inc.	BRLT
TrueCar, Inc.	TRUE
Unity Bancorp, Inc.	UNTY
Telomir Pharmaceuticals, Inc.	TELO
Sharecare, Inc.	SHCR
Superior Group of Companies, Inc.	SGC
The Lion Electric Company	LEV
Actinium Pharmaceuticals, Inc.	ATNM
Telos Corporation	TLS
Carter Bankshares, Inc.	CARE
Sierra Bancorp	BSRR
Adaptimmune Therapeutics plc	ADAP
Poseida Therapeutics, Inc.	PSTX
Peoples Financial Services Corp.	PFIS
Financial Institutions, Inc.	FISI
Southern California Bancorp	BCAL
Ranger Energy Services, Inc.	RNGR
Fidelity D & D Bancorp, Inc.	FDBC
Citizens & Northern Corporation	CZNC
Orion Group Holdings, Inc.	ORN
Dingdong (Cayman) Limited	DDL
Gran Tierra Energy Inc.	GTE
Primis Financial Corp.	FRST
Orange County Bancorp, Inc.	OBT
Red Violet, Inc.	RDVT
VersaBank	VBNK
Hyliion Holdings Corp.	HYLN
Valens Semiconductor Ltd.	VLN
FREYR Battery	FREY
Intuitive Machines, Inc.	LUNR
Western Copper and Gold Corporation	WRN
Industrial Logistics Properties Trust	ILPT
2seventy bio, Inc.	TSVT
Nyxoah S.A.	NYXH
Inovio Pharmaceuticals, Inc.	INO
Rimini Street, Inc.	RMNI
NaaS Technology Inc.	NAAS
Patria Latin American Opportunity Acquisition Corp.	PLAO
Senseonics Holdings, Inc.	SENS
AngioDynamics, Inc.	ANGO
American Realty Investors, Inc.	ARL
Puma Biotechnology, Inc.	PBYI
Bank7 Corp.	BSVN
AVITA Medical, Inc.	RCEL
MVB Financial Corp.	MVBF
Century Therapeutics, Inc.	IPSC
Redwire Corporation	RDW
Lesaka Technologies, Inc.	LSAK
Third Coast Bancshares, Inc.	TCBX
Boundless Bio, Inc.	BOLD
Inspired Entertainment, Inc.	INSE
Cardiff Oncology, Inc.	CRDF
GeneDx Holdings Corp.	WGS
Blink Charging Co.	BLNK
Aldeyra Therapeutics, Inc.	ALDX
Quad/Graphics, Inc.	QUAD
Gencor Industries, Inc.	GENC
Northrim BanCorp, Inc.	NRIM
TriSalus Life Sciences, Inc.	TLSI
Ceragon Networks Ltd.	CRNT
FutureFuel Corp.	FF
Coherus BioSciences, Inc.	CHRS
The First Bancorp, Inc.	FNLC
IBEX Limited	IBEX
JAKKS Pacific, Inc.	JAKK
Euroseas Ltd.	ESEA
Utah Medical Products, Inc.	UTMD
Generation Bio Co.	GBIO
FS Bancorp, Inc.	FSBW
Galectin Therapeutics Inc.	GALT
Spring Valley Acquisition Corp. II	SVII
Piedmont Lithium Inc.	PLL
Lineage Cell Therapeutics, Inc.	LCTX
Companhia Brasileira de Distribuição	CBD
New England Realty Associates LP	NEN
Dakota Gold Corp.	DC
Bank of Marin Bancorp	BMRC
Radiant Logistics, Inc.	RLGT
Regional Management Corp.	RM
Consensus Cloud Solutions, Inc.	CCSI
Adverum Biotechnologies, Inc.	ADVM
Bit Digital, Inc.	BTBT
Sterling Bancorp, Inc. (Southfield, MI)	SBT
Arq, Inc.	ARQ
HomeStreet, Inc.	HMST
San Juan Basin Royalty Trust	SJT
Cartesian Growth Corporation II	RENE
DouYu International Holdings Limited	DOYU
Plum Acquisition Corp. III	PLMJ
Southland Holdings, Inc.	SLND
Quantum-Si incorporated	QSI
Forum Energy Technologies, Inc.	FET
AFC Gamma, Inc.	AFCG
Priority Technology Holdings, Inc.	PRTH
Agora, Inc.	API
G1 Therapeutics, Inc.	GTHX
Vanda Pharmaceuticals Inc.	VNDA
Helix Acquisition Corp. II	HLXB
LINKBANCORP, Inc.	LNKB
Conduit Pharmaceuticals Inc.	CDT
Pioneer Bancorp, Inc.	PBFS
Clarus Corporation	CLAR
Pure Cycle Corporation	PCYO
Datasea Inc.	DTSS
Lanvin Group Holdings Limited	LANV
Kingsway Financial Services Inc.	KFS
Kodiak Sciences Inc.	KOD
Twin Disc, Incorporated	TWIN
PaySign, Inc.	PAYS
Elevation Oncology, Inc.	ELEV
BayCom Corp	BCML
NexPoint Real Estate Finance, Inc.	NREF
Concord Acquisition Corp II	CNDA
Bridger Aerospace Group Holdings, Inc.	BAER
uniQure N.V.	QURE
The First of Long Island Corporation	FLIC
Immersion Corporation	IMMR
Fluent, Inc.	FLNT
CommScope Holding Company, Inc.	COMM
Waterstone Financial, Inc.	WSBF
Solidion Technology Inc.	STI
Sify Technologies Limited	SIFY
Atlas Lithium Corporation	ATLX
Universal Stainless & Alloy Products, Inc.	USAP
Ovid Therapeutics Inc.	OVID
Legato Merger Corp. III	LEGT
Accuray Incorporated	ARAY
Mesabi Trust	MSB
The Aaron's Company, Inc.	AAN
X4 Pharmaceuticals, Inc.	XFOR
Civista Bancshares, Inc.	CIVB
Acumen Pharmaceuticals, Inc.	ABOS
Granite Point Mortgage Trust Inc.	GPMT
Colombier Acquisition Corp.	CLBR
Stereotaxis, Inc.	STXS
Veru Inc.	VERU
Battery Future Acquisition Corp.	BFAC
American Public Education, Inc.	APEI
Tredegar Corporation	TG
Acrivon Therapeutics, Inc.	ACRV
Scilex Holding Company	SCLX
CONX Corp.	CONX
John Marshall Bancorp, Inc.	JMSB
iRobot Corporation	IRBT
Cheche Group Inc	CCG
Five Point Holdings, LLC	FPH
Belpointe PREP, LLC	OZ
Omeros Corporation	OMER
Fanhua Inc.	FANH
PCB Bancorp	PCB
Southern First Bancshares, Inc.	SFST
Lifetime Brands, Inc.	LCUT
Franklin Street Properties Corp.	FSP
EMX Royalty Corporation	EMX
Citizens Financial Services, Inc.	CZFS
23andMe Holding Co.	ME
SWK Holdings Corporation	SWKH
Merrimack Pharmaceuticals, Inc.	MACK
Commercial Vehicle Group, Inc.	CVGI
bluebird bio, Inc.	BLUE
Maiden Holdings, Ltd.	MHLD
Northeast Community Bancorp, Inc.	NECB
NACCO Industries, Inc.	NC
Rigel Pharmaceuticals, Inc.	RIGL
Canaan Inc.	CAN
RCF Acquisition Corp.	RCFA
Alico, Inc.	ALCO
Smith-Midland Corporation	SMID
StealthGas Inc.	GASS
Zevra Therapeutics, Inc.	ZVRA
EZGO Technologies Ltd.	EZGO
Atossa Therapeutics, Inc.	ATOS
Southern States Bancshares, Inc.	SSBK
Alpine Income Property Trust, Inc.	PINE
Whole Earth Brands, Inc.	FREE
Plumas Bancorp	PLBC
1stdibs.Com, Inc.	DIBS
Design Therapeutics, Inc.	DSGN
Blue Foundry Bancorp	BLFY
Abeona Therapeutics Inc.	ABEO
Compass Therapeutics, Inc.	CMPX
USCB Financial Holdings, Inc.	USCB
Codorus Valley Bancorp, Inc.	CVLY
Caledonia Mining Corporation Plc	CMCL
Ellomay Capital Ltd.	ELLO
CPI Card Group Inc.	PMTS
Murano Global Investments PLC	MRNO
Standard Lithium Ltd.	SLI
Enphys Acquisition Corp.	NFYS
Keen Vision Acquisition Corporation	KVAC
Akoya Biosciences, Inc.	AKYA
RGC Resources, Inc.	RGCO
Townsquare Media, Inc.	TSQ
Lucas GC Limited	LGCL
Gores Holdings IX, Inc.	GHIX
Timberland Bancorp, Inc.	TSBK
Gossamer Bio, Inc.	GOSS
QuantaSing Group Ltd	QSG
Codexis, Inc.	CDXS
Nouveau Monde Graphite Inc.	NMG
Iteris, Inc.	ITI
Contango Ore, Inc.	CTGO
Trevi Therapeutics, Inc.	TRVI
Magnachip Semiconductor Corporation	MX
Greenwich LifeSciences, Inc.	GLSI
Outbrain Inc.	OB
Innate Pharma S.A.	IPHA
Werewolf Therapeutics, Inc.	HOWL
908 Devices Inc.	MASS
The Eastern Company	EML
SDCL EDGE Acquisition Corporation	SEDA
Offerpad Solutions Inc.	OPAD
Osisko Development Corp.	ODV
Innoviz Technologies Ltd.	INVZ
Everest Consolidator Acquisition Corporation	MNTN
RumbleON, Inc.	RMBL
Capricor Therapeutics, Inc.	CAPR
Tucows Inc.	TCX
Rocky Brands, Inc.	RCKY
Alpha Tau Medical Ltd.	DRTS
Hooker Furnishings Corporation	HOFT
Citi Trends, Inc.	CTRN
Flexsteel Industries, Inc.	FLXS
Vera Bradley, Inc.	VRA
Candel Therapeutics, Inc.	CADL
System1, Inc.	SST
Ooma, Inc.	OOMA
OptimizeRx Corporation	OPRX
BARK, Inc.	BARK
Virco Mfg. Corporation	VIRC
Semler Scientific, Inc.	SMLR
Cango Inc.	CANG
eGain Corporation	EGAN
Profound Medical Corp.	PROF
Cellectis S.A.	CLLS
Consumer Portfolio Services, Inc.	CPSS
Parke Bancorp, Inc.	PKBK
Evolution Petroleum Corporation	EPM
Norwood Financial Corp.	NWFL
Lotus Technology Inc.	LOT
Oak Valley Bancorp	OVLY
Mondee Holdings, Inc.	MOND
Ponce Financial Group, Inc.	PDLB
Bankwell Financial Group, Inc.	BWFG
NN, Inc.	NNBR
Oxford Square Capital Corp.	OXSQ
Digital Turbine, Inc.	APPS
Compugen Ltd.	CGEN
D-Wave Quantum Inc.	QBTS
Destination XL Group, Inc.	DXLG
BlackSky Technology Inc.	BKSY
Seven Hills Realty Trust	SEVN
SoundThinking Inc	SSTI
Kaltura, Inc.	KLTR
Aeva Technologies, Inc.	AEVA
QuickLogic Corporation	QUIK
Performant Financial Corporation	PFMT
Outlook Therapeutics, Inc.	OTLK
Chemung Financial Corporation	CHMG
INmune Bio, Inc.	INMB
First Financial Northwest, Inc.	FFNW
Rigetti Computing, Inc.	RGTI
Asure Software, Inc.	ASUR
Princeton Bancorp Inc	BPRN
Inventiva S.A.	IVA
Caesarstone Ltd.	CSTE
Augmedix, Inc.	AUGX
Colony Bankcorp, Inc.	CBAN
Northern Dynasty Minerals Ltd.	NAK
Butterfly Network, Inc.	BFLY
Lifecore Biomedical, Inc.	LFCR
Adlai Nortye Ltd.	ANL
Project Energy Reimagined Acquisition Corp.	PEGR
P3 Health Partners Inc.	PIII
LCNB Corp.	LCNB
Entravision Communications Corporation	EVC
Alimera Sciences, Inc.	ALIM
Harvard Bioscience, Inc.	HBIO
Regulus Therapeutics Inc.	RGLS
California BanCorp	CALB
Investcorp India Acquisition Corp	IVCA
Kandi Technologies Group, Inc.	KNDI
OrganiGram Holdings Inc.	OGI
FVCBankcorp, Inc.	FVCB
PrimeEnergy Resources Corporation	PNRG
Quest Resource Holding Corporation	QRHC
LENZ Therapeutics, Inc.	LENZ
Innodata Inc.	INOD
X3 Holdings Co Ltd.	XTKG
Airship AI Holdings, Inc.	AISP
ThredUp Inc.	TDUP
Medallion Financial Corp.	MFIN
Vertical Aerospace Ltd.	EVTL
Ocwen Financial Corporation	OCN
SilverBox Corp III	SBXC
HireQuest, Inc.	HQI
City Office REIT, Inc.	CIO
Veritone, Inc.	VERI
Tristar Acquisition I Corp.	TRIS
Portman Ridge Finance Corporation	PTMN
Purple Innovation, Inc.	PRPL
Stratus Properties Inc.	STRS
The Joint Corp.	JYNT
Middlefield Banc Corp.	MBCN
Escalade, Incorporated	ESCA
Eos Energy Enterprises, Inc.	EOSE
VOXX International Corporation	VOXX
Full House Resorts, Inc.	FLL
Information Services Group, Inc.	III
Mama's Creations, Inc.	MAMA
Genfit S.A.	GNFT
ProQR Therapeutics N.V.	PRQR
scPharmaceuticals Inc.	SCPH
Adicet Bio, Inc.	ACET
AP Acquisition Corp.	APCA
KNOT Offshore Partners LP	KNOP
Kopin Corporation	KOPN
Orion Office REIT Inc.	ONL
Tilly's, Inc.	TLYS
Orchestra BioMed Holdings, Inc.	OBIO
Geospace Technologies Corporation	GEOS
Hennessy Capital Investment Corp. VI	HCVI
Ames National Corporation	ATLO
TH International Limited	THCH
Rekor Systems, Inc.	REKR
Inogen, Inc.	INGN
EVe Mobility Acquisition Corp	EVE
National Bankshares, Inc.	NKSH
Seanergy Maritime Holdings Corp.	SHIP
Agenus Inc.	AGEN
The ONE Group Hospitality, Inc.	STKS
InfuSystem Holdings, Inc.	INFU
High Tide Inc.	HITI
Brand Engagement Network, Inc.	BNAI
Aemetis, Inc.	AMTX
SK Growth Opportunities Corporation	SKGR
Energy Vault Holdings, Inc.	NRGV
Spark I Acquisition Corp. Class A Ordinary Share	SPKL
Vericity, Inc.	VERY
Generation Asia I Acquisition Limited	GAQ
CSP Inc.	CSPI
ChoiceOne Financial Services, Inc.	COFS
GoldMining Inc.	GLDG
Burtech Acquisition Corp.	BRKH
American Well Corporation	AMWL
Amprius Technologies, Inc.	AMPX
AG Mortgage Investment Trust, Inc.	MITT
BCB Bancorp, Inc.	BCBP
DLH Holdings Corp.	DLHC
Learn CW Investment Corporation	LCW
Hallador Energy Company	HNRG
HF Foods Group Inc.	HFFG
Everspin Technologies, Inc.	MRAM
Perma-Fix Environmental Services, Inc.	PESI
Microvast Holdings, Inc.	MVST
Braemar Hotels & Resorts Inc.	BHR
ESSA Bancorp, Inc.	ESSA
Mountain & Co. I Acquisition Corp.	MCAA
Atomera Incorporated	ATOM
FiscalNote Holdings, Inc.	NOTE
Vast Renewables Limited	VSTE
Star Holdings	STHO
YS Biopharma Co., Ltd.	YS
FingerMotion, Inc.	FNGR
Quipt Home Medical Corp.	QIPT
AudioEye, Inc.	AEYE
Cybin Inc.	CYBN
Sangoma Technologies Corporation	SANG
374Water, Inc.	SCWO
LiveOne, Inc.	LVO
Security National Financial Corporation	SNFCA
ASP Isotopes Inc.	ASPI
Hyzon Motors Inc.	HYZN
Mynd.ai, Inc.	MYND
Core Molding Technologies, Inc.	CMT
Alchemy Investments Acquisition Corp 1	ALCY
Pyrophyte Acquisition Corp.	PHYT
MSP Recovery, Inc.	LIFW
Bakkt Holdings, Inc.	BKKT
Vaxart, Inc.	VXRT
SolarBank Corporation	SUUN
Mammoth Energy Services, Inc.	TUSK
ClearPoint Neuro, Inc.	CLPT
Alto Ingredients, Inc.	ALTO
Cadiz Inc.	CDZI
Niu Technologies	NIU
Haoxi Health Technology Limited	HAO
CervoMed Inc.	CRVO
Acme United Corporation	ACU
GlycoMimetics, Inc.	GLYC
RCM Technologies, Inc.	RCMT
Smart Share Global Limited	EM
Canoo Inc.	GOEV
Monroe Capital Corporation	MRCC
Sagimet Biosciences Inc.	SGMT
Repare Therapeutics Inc.	RPTX
Inotiv, Inc.	NOTV
Vacasa, Inc.	VCSA
Investar Holding Corporation	ISTR
Li-Cycle Holdings Corp.	LICY
Massimo Group	MAMO
Duluth Holdings Inc.	DLTH
Gevo, Inc.	GEVO
Sachem Capital Corp.	SACH
Solowin Holdings Ordinary Share	SWIN
InFinT Acquisition Corporation	IFIN
ESH Acquisition Corp.	ESHA
FTAC Emerald Acquisition Corp.	EMLD
MediWound Ltd.	MDWD
X Financial	XYF
Peoples Bancorp of North Carolina, Inc.	PEBK
BioAtla, Inc.	BCAB
I-Mab	IMAB
Arrowroot Acquisition Corp.	ARRW
International Tower Hill Mines Ltd.	THM
AXT, Inc.	AXTI
Blockchain Coinvestors Acquisition Corp. I	BCSA
Shengfeng Development Limited	SFWL
First United Corporation	FUNC
Evans Bancorp, Inc.	EVBN
Hawthorn Bancshares, Inc.	HWBK
Achieve Life Sciences, Inc.	ACHV
Arbe Robotics Ltd.	ARBE
Captivision Inc.	CAPT
Alarum Technologies Ltd.	ALAR
Omega Therapeutics, Inc.	OMGA
Ultralife Corporation	ULBI
inTEST Corporation	INTT
Zura Bio Limited	ZURA
GrowGeneration Corp.	GRWG
CytomX Therapeutics, Inc.	CTMX
American Lithium Corp.	AMLI
Viant Technology Inc.	DSP
10X Capital Venture Acquisition Corp. III	VCXB
Modiv Inc.	MDV
IB Acquisition Corp.	IBAC
Syros Pharmaceuticals, Inc.	SYRS
WW International, Inc.	WW
Amylyx Pharmaceuticals, Inc.	AMLX
Taylor Devices, Inc.	TAYD
RADCOM Ltd.	RDCM
ZeroFox Holdings, Inc.	ZFOX
eHealth, Inc.	EHTH
Biodesix, Inc.	BDSX
Provident Bancorp, Inc.	PVBC
Karyopharm Therapeutics Inc.	KPTI
Relmada Therapeutics, Inc.	RLMD
Silvercrest Asset Management Group Inc.	SAMG
Village Farms International, Inc.	VFF
Israel Acquisitions Corp	ISRL
Prairie Operating Co.	PROP
Twelve Seas Investment Company II	TWLV
Empire Petroleum Corporation	EP
Virginia National Bankshares Corporation	VABK
Alpha Star Acquisition Corporation	ALSA
Western New England Bancorp, Inc.	WNEB
Richardson Electronics, Ltd.	RELL
RE/MAX Holdings, Inc.	RMAX
OptiNose, Inc.	OPTN
Bragg Gaming Group Inc.	BRAG
Drilling Tools International Corp.	DTI
VirTra, Inc.	VTSI
Satellogic Inc.	SATL
Athena Technology Acquisition Corp. II	ATEK
OP Bancorp	OPBK
C&F Financial Corporation	CFFI
Friedman Industries, Incorporated	FRD
Penns Woods Bancorp, Inc.	PWOD
OPAL Fuels Inc.	OPAL
Valuence Merger Corp. I	VMCA
DBV Technologies S.A.	DBVT
Saga Communications, Inc.	SGA
G. Willi-Food International Ltd.	WILC
Markforged Holding Corporation	MKFG
ArrowMark Financial Corp.	BANX
TLGY Acquisition Corporation	TLGY
Zomedica Corp.	ZOM
VistaGen Therapeutics, Inc.	VTGN
Loop Industries, Inc.	LOOP
Platinum Group Metals Ltd.	PLG
Coya Therapeutics, Inc.	COYA
Ellington Residential Mortgage REIT	EARN
Direct Digital Holdings, Inc.	DRCT
Northern Technologies International Corporation	NTIC
Skillz Inc.	SKLZ
First Western Financial, Inc.	MYFW
Global Partner Acquisition Corp II	GPAC
Zalatoris II Acquisition Corp.	ZLS
99 Acquisition Group Inc.	NNAG
Molecular Partners AG	MOLN
FitLife Brands, Inc.	FTLF
Vor Biopharma Inc.	VOR
Immunic, Inc.	IMUX
OFS Capital Corporation	OFS
Universal Electronics Inc.	UEIC
Douglas Elliman Inc.	DOUG
AstroNova, Inc.	ALOT
Neuronetics, Inc.	STIM
FibroGen, Inc.	FGEN
BankFinancial Corporation	BFIN
PSQ Holdings, Inc.	PSQH
MainStreet Bancshares, Inc.	MNSB
Annovis Bio, Inc.	ANVS
TruBridge, Inc.	TBRG
Pinstripes Holdings Inc.	PNST
KLX Energy Services Holdings, Inc.	KLXE
United Security Bancshares	UBFO
CNFinance Holdings Limited	CNF
RMG Acquisition Corp. III	RMGC
Direct Selling Acquisition Corp.	DSAQ
Focus Impact Acquisition Corp.	FIAC
Planet Image International Limited	YIBO
Xiao-I Corporation	AIXI
First Guaranty Bancshares, Inc.	FGBI
U-BX Technology Ltd.	UBXG
Citius Pharmaceuticals, Inc.	CTXR
Hurco Companies, Inc.	HURC
Electromed, Inc.	ELMD
First Community Corporation	FCCO
Plum Acquisition Corp. I	PLMI
Papaya Growth Opportunity Corp. I	PPYA
Nuvectis Pharma, Inc.	NVCT
Kensington Capital Acquisition Corp. V	KCGI
Richmond Mutual Bancorporation, Inc.	RMBI
Marblegate Acquisition Corp.	GATE
Lument Finance Trust, Inc.	LFT
New Providence Acquisition Corp. II	NPAB
TAT Technologies Ltd.	TATT
Sportsman's Warehouse Holdings, Inc.	SPWH
Union Bankshares, Inc.	UNB
Lantronix, Inc.	LTRX
Syntec Optics Holdings, Inc.	OPTX
Lakeland Industries, Inc.	LAKE
PHX Minerals Inc.	PHX
a.k.a. Brands Holding Corp.	AKA
TPI Composites, Inc.	TPIC
Sunlands Technology Group	STG
So-Young International Inc.	SY
Energy Services of America Corporation	ESOA
Motorcar Parts of America, Inc.	MPAA
FinWise Bancorp	FINW
ContextLogic Inc.	WISH
Expensify, Inc.	EXFY
Delcath Systems, Inc.	DCTH
Cheetah Mobile Inc.	CMCM
Bassett Furniture Industries, Incorporated	BSET
Barinthus Biotherapeutics plc	BRNS
TELA Bio, Inc.	TELA
Emeren Group Ltd	SOL
Travelzoo	TZOO
Cardiol Therapeutics Inc.	CRDL
Blue Ocean Acquisition Corp.	BOCN
Westwood Holdings Group, Inc.	WHG
Crexendo, Inc.	CXDO
Kolibri Global Energy Inc.	KGEI
The L.S. Starrett Company	SCX
Zentek Ltd.	ZTEK
ECB Bancorp, Inc.	ECBK
Brooge Energy Limited	BROG
Eliem Therapeutics, Inc.	ELYM
Seer, Inc.	SEER
TROOPS, Inc.	TROO
Vigil Neuroscience, Inc.	VIGL
Identiv, Inc.	INVE
Epsilon Energy Ltd.	EPSN
FAT Brands Inc.	FAT
CF Bankshares Inc.	CFBK
Corner Growth Acquisition Corp.	COOL
aTyr Pharma, Inc.	LIFE
ProPhase Labs, Inc.	PRPH
Freightos Limited	CRGO
Innovative Solutions and Support, Inc.	ISSC
Armata Pharmaceuticals, Inc.	ARMP
PDS Biotechnology Corporation	PDSB
William Penn Bancorporation	WMPN
NEXGEL, Inc.	NXGL
The9 Limited	NCTY
Taitron Components Incorporated	TAIT
Trio Petroleum Corp.	TPET
Talphera, Inc.	TLPH
HWH International Inc.	HWH
Aesthetic Medical International Holdings Group Limited	AIH
PharmaCyte Biotech, Inc.	PMCB
Focus Universal Inc.	FCUV
Delta Apparel, Inc.	DLA
Presto Automation, Inc.	PRST
Snow Lake Resources Ltd.	LITM
Jaguar Health, Inc.	JAGX
SIFCO Industries, Inc.	SIF
Agape ATP Corporation	ATPC
American Shared Hospital Services	AMS
Galecto, Inc.	GLTO
Rubicon Technologies, Inc.	RBT
S&W Seed Company	SANW
Aterian, Inc.	ATER
HeartCore Enterprises, Inc.	HTCR
BM Technologies, Inc.	BMTX
Traws Pharma Inc.	TRAW
Cineverse Corp.	CNVS
STRATA Skin Sciences, Inc.	SSKN
Sound Group Inc.	SOGP
Yunji Inc.	YJ
NeuroBo Pharmaceuticals, Inc.	NRBO
Pintec Technology Holdings Limited	PT
PAVmed Inc.	PAVM
Graphex Group Limited	GRFX
Sadot Group Inc.	SDOT
SPI Energy Co., Ltd.	SPI
Ohmyhome Limited	OMH
Gyrodyne, LLC	GYRO
Xcel Brands, Inc.	XELB
Minerva Neurosciences, Inc.	NERV
Mawson Infrastructure Group, Inc.	MIGI
BiomX Inc.	PHGE
Foresight Autonomous Holdings Ltd.	FRSX
T2 Biosystems, Inc.	TTOO
MicroCloud Hologram Inc.	HOLO
Unusual Machines, Inc.	UMAC
ATI Physical Therapy, Inc.	ATIP
iBio, Inc.	IBIO
Laser Photonics Corporation	LASE
SRM Entertainment, Inc.	SRM
Nexalin Technology, Inc.	NXL
Brera Holdings PLC	BREA
Pieris Pharmaceuticals, Inc.	PIRS
BitFuFu Inc.	FUFU
Dominari Holdings Inc.	DOMH
Purple Biotech Ltd.	PPBT
Meihua International Medical Technologies Co., Ltd.	MHUA
Orgenesis Inc.	ORGS
GameSquare Holdings Inc	GAME
AtlasClear Holdings, Inc.	ATCH
LiqTech International, Inc.	LIQT
TSR, Inc.	TSRI
Astrotech Corporation	ASTC
NeurAxis, Inc.	NRXS
Planet Green Holdings Corp.	PLAG
Zapp Electric Vehicles Group Limited	ZAPP
Mill City Ventures III, Ltd.	MCVT
Barfresh Food Group, Inc.	BRFH
Mainz Biomed B.V.	MYNZ
Ashford Inc.	AINC
Vintage Wine Estates, Inc.	VWE
Bit Origin Limited	BTOG
VerifyMe, Inc.	VRME
B.O.S. Better Online Solutions Ltd.	BOSC
Aytu BioPharma, Inc.	AYTU
Mannatech, Incorporated	MTEX
Psychemedics Corporation	PMD
Fathom Digital Manufacturing Corporation	FATH
Air Industries Group	AIRI
Next Technology Holding Inc.	NXTT
DigiAsia Corp.	FAAS
MOGU Inc.	MOGU
Draganfly Inc.	DPRO
Hitek Global Inc.	HKIT
Evaxion Biotech A/S	EVAX
Regis Corporation	RGS
Millennium Group International Holdings Limited	MGIH
Singularity Future Technology Ltd.	SGLY
Senti Biosciences, Inc.	SNTI
Centogene N.V.	CNTG
Talis Biomedical Corporation	TLIS
Avalo Therapeutics, Inc.	AVTX
OneMedNet Corporation	ONMD
Glen Burnie Bancorp	GLBZ
Patriot National Bancorp, Inc.	PNBK
Austin Gold Corp.	AUST
CISO Global Inc	CISO
Xinyuan Real Estate Co., Ltd.	XIN
Immuron Limited	IMRN
Minim, Inc.	MINM
Kiora Pharmaceuticals, Inc.	KPRX
Chicago Rivet & Machine Co.	CVR
MDJM Ltd	MDJH
Exela Technologies, Inc.	XELA
Dogness (International) Corporation	DOGZ
Imunon, Inc.	IMNN
Splash Beverage Group, Inc.	SBEV
Inspirato Incorporated	ISPO
Gulf Resources, Inc.	GURE
Cocrystal Pharma, Inc.	COCP
American Strategic Investment Co	NYC
NanoViricides, Inc.	NNVC
Verb Technology Company, Inc.	VERB
China SXT Pharmaceuticals, Inc.	SXTC
Microbot Medical Inc.	MBOT
Nocera, Inc.	NCRA
GigaMedia Limited	GIGM
36Kr Holdings Inc.	KRKR
Electro-Sensors, Inc.	ELSE
Coeptis Therapeutics, Inc.	COEP
Royalty Management Holding Corporation	RMCO
Benitec Biopharma Inc.	BNTC
Skillful Craftsman Education Technology Limited	EDTK
Trinity Biotech plc	TRIB
Edesa Biotech, Inc.	EDSA
Inhibikase Therapeutics, Inc.	IKT
Star Equity Holdings, Inc.	STRR
Nauticus Robotics, Inc.	KITT
Ocean Power Technologies, Inc.	OPTT
Sidus Space, Inc.	SIDU
iPower Inc.	IPW
Biomerica, Inc.	BMRA
Magic Empire Global Limited	MEGL
Iveda Solutions, Inc.	IVDA
VBI Vaccines Inc.	VBIV
Tonix Pharmaceuticals Holding Corp.	TNXP
Steakholder Foods Ltd.	STKH
HNR Acquisition Corp	HNRA
Monopar Therapeutics Inc.	MNPR
Expion360 Inc.	XPON
Bridgeline Digital, Inc.	BLIN
MIRA Pharmaceuticals, Inc.	MIRA
iCoreConnect Inc.	ICCT
Check-Cap Ltd.	CHEK
Advanced Human Imaging Limited	AHI
DSS, Inc.	DSS
Turbo Energy, S.A.	TURB
XTL Biopharmaceuticals Ltd.	XTLB
Cohen & Company Inc.	COHN
ShiftPixy, Inc.	PIXY
Hongli Group Inc.	HLP
Astra Space, Inc.	ASTR
Presidio Property Trust, Inc.	SQFT
Future FinTech Group Inc.	FTFT
Advent Technologies Holdings, Inc.	ADN
HUB Cyber Security (Israel) Ltd.	HUBC
Maris-Tech Ltd.	MTEK
BioSig Technologies, Inc.	BSGM
RedHill Biopharma Ltd.	RDHL
InnSuites Hospitality Trust	IHT
VivoPower International PLC	VVPR
Janover Inc.	JNVR
BurgerFi International, Inc.	BFI
FGI Industries Ltd.	FGI
TOMI Environmental Solutions, Inc.	TOMZ
U Power Limited	UCAR
Castellum, Inc.	CTM
Ryvyl Inc.	RVYL
TDH Holdings, Inc.	PETZ
Golden Heaven Group Holdings Ltd.	GDHG
Telesis Bio, Inc.	TBIO
Medalist Diversified REIT, Inc.	MDRR
Inno Holdings Inc.	INHD
Euro Tech Holdings Company Limited	CLWT
CareMax, Inc.	CMAX
Zhongchao Inc.	ZCMD
The Real Good Food Company, Inc.	RGF
Eterna Therapeutics Inc.	ERNA
Genetic Technologies Limited	GENE
BIMI International Medical Inc.	BIMI
Shapeways Holdings, Inc.	SHPW
Cosmos Health Inc.	COSM
Cyngn Inc.	CYN
SIMPPLE LTD.	SPPL
NuCana plc	NCNA
ParaZero Technologies Ltd.	PRZO
China Natural Resources, Inc.	CHNR
Emerson Radio Corp.	MSN
Chromocell Therapeutics Corp	CHRO
Worksport Ltd.	WKSP
ABVC BioPharma, Inc.	ABVC
Lendway, Inc.	LDWY
Global Gas Corporation	HGAS
EZFill Holdings Inc.	EZFL
Upexi, Inc.	UPXI
EpicQuest Education Group International Limited	EEIQ
Prestige Wealth Inc.	PWM
GlucoTrack, Inc.	GCTK
Spectaire Holdings Inc.	SPEC
Wheeler Real Estate Investment Trust, Inc.	WHLR
BT Brands, Inc.	BTBD
MingZhu Logistics Holdings Limited	YGMZ
Conifer Holdings, Inc.	CNFR
Chemomab Therapeutics Ltd.	CMMB
Pineapple Financial Inc.	PAPL
Kelso Technologies Inc.	KIQ
Psyence Biomedical Ltd.	PBM
Blue Hat Interactive Entertainment Technology	BHAT
Marine Petroleum Trust	MARPS
Ontrak, Inc.	OTRK
SaverOne 2014 Ltd	SVRE
Adamas One Corp.	JEWL
Northann Corp.	NCL
Ideanomics, Inc.	IDEX
Biotricity, Inc.	BTCY
Bionomics Limited	BNOX
Biofrontera Inc.	BFRI
Smart Powerr Corp.	CREG
Notable Labs, Ltd.	NTBL
Moleculin Biotech, Inc.	MBRX
BioCardia, Inc.	BCDA
iSun, Inc.	ISUN
Elevai Labs, Inc.	ELAB
Lottery.com Inc.	LTRY
Energous Corporation	WATT
Molecular Templates, Inc.	MTEM
Guardion Health Sciences, Inc.	GHSI
Organovo Holdings, Inc.	ONVO
The OLB Group, Inc.	OLB
Art's-Way Manufacturing Co., Inc.	ARTW
ATIF Holdings Limited	ATIF
Kazia Therapeutics Limited	KZIA
Safe and Green Development Corporation	SGD
Earlyworks Co., Ltd	ELWS
Can-Fite BioPharma Ltd.	CANF
Virios Therapeutics, Inc.	VIRI
Fresh Vine Wine, Inc.	VINE
Paranovus Entertainment Technology Ltd.	PAVS
Jet.AI Inc.	JTAI
Ault Alliance, Inc.	AULT
GSE Systems, Inc.	GVP
TFF Pharmaceuticals, Inc.	TFFP
Highway Holdings Limited	HIHO
Altisource Asset Management Corporation	AAMC
Multi Ways Holdings Ltd	MWG
Aeterna Zentaris Inc.	AEZS
VS Media Holdings Limited	VSME
Signing Day Sports Inc.	SGN
VIA optronics AG	VIAO
Hepion Pharmaceuticals, Inc.	HEPA
Golden Minerals Company	AUMN
Greenpro Capital Corp.	GRNQ
Adial Pharmaceuticals, Inc.	ADIL
ENGlobal Corporation	ENG
Strong Global Entertainment, Inc.	SGE
ProSomnus, Inc.	OSA
Fresh2 Group Ltd	FRES
Precipio, Inc.	PRPO
Cyclerion Therapeutics, Inc.	CYCN
Charles & Colvard, Ltd.	CTHR
BioRestorative Therapies, Inc.	BRTX
Portage Biotech Inc.	PRTG
Trinity Place Holdings Inc.	TPHS
Wearable Devices Ltd.	WLDS
Visionary Holdings Inc.	GV
Marin Software Incorporated	MRIN
Avalon Holdings Corporation	AWX
Coffee Holding Co., Inc.	JVA
TRxADE HEALTH, Inc.	MEDS
T Stamp Inc.	IDAI
Yoshitsu Co., Ltd	TKLF
Blackboxstocks Inc.	BLBX
NewGenIvf Group Limited	NIVF
Luokung Technology Corp.	LKCO
Vaccinex, Inc.	VCNX
Intelligent Bio Solutions Inc.	INBS
Galera Therapeutics, Inc.	GRTX
Wah Fu Education Group Limited	WAFU
Roma Green Finance Limited	ROMA
Twin Vee Powercats Co.	VEEE
Uxin Limited	UXIN
Syra Health Corp.	SYRA
IM Cannabis Corp.	IMCC
ASLAN Pharmaceuticals Limited	ASLN
Enservco Corporation	ENSV
Intelligent Living Application Group Inc.	ILAG
Super League Enterprise, Inc.	SLE
Selina Hospitality PLC	SLNA
JX Luxventure Limited	JXJT
Socket Mobile, Inc.	SCKT
Warrantee Inc.	WRNT
Vislink Technologies, Inc.	VISL
Novo Integrated Sciences, Inc.	NVOS
Erayak Power Solution Group Inc.	RAYA
Akari Therapeutics, Plc	AKTX
Antelope Enterprise Holdings Limited	AEHL
Pop Culture Group Co., Ltd	CPOP
Sunshine Biopharma, Inc.	SBFM
Plus Therapeutics, Inc.	PSTV
Clever Leaves Holdings Inc.	CLVR
Polar Power, Inc.	POLA
Pulmatrix, Inc.	PULM
Banzai International, Inc.	BNZI
Lixte Biotechnology Holdings, Inc.	LIXT
Ostin Technology Group Co., Ltd.	OST
Pasithea Therapeutics Corp.	KTTA
AgEagle Aerial Systems, Inc.	UAVS
Theriva Biologics, Inc.	TOVX
The Dixie Group, Inc.	DXYN
eFFECTOR Therapeutics, Inc.	EFTR
WANG & LEE GROUP, Inc.	WLGS
PolyPid Ltd.	PYPD
AirNet Technology Inc.	ANTE
Motorsport Games Inc.	MSGM
Kidpik Corp.	PIK
Vision Marine Technologies Inc.	VMAR
Golden Sun Education Group Limited	GSUN
Kaival Brands Innovations Group, Inc.	KAVL
NeuroMetrix, Inc.	NURO
Enveric Biosciences, Inc.	ENVB
Tenax Therapeutics, Inc.	TENX
Avinger, Inc.	AVGR
AEye, Inc.	LIDR
Forza X1, Inc.	FRZA
Vivos Therapeutics, Inc.	VVOS
ZW Data Action Technologies Inc.	CNET
Sacks Parente Golf, Inc.	SPGC
Senmiao Technology Limited	AIHS
AquaBounty Technologies, Inc.	AQB
Predictive Oncology Inc.	POAI
Mobilicom Ltd	MOB
MIND Technology, Inc.	MIND
Creative Medical Technology Holdings, Inc.	CELZ
ESGL Holdings Ltd	ESGL
Gaxos.ai Inc.	GXAI
LM Funding America, Inc.	LMFA
Heart Test Laboratories, Inc.	HSCS
SemiLEDs Corporation	LEDS
Healthcare Triangle, Inc.	HCTI
Kintara Therapeutics, Inc.	KTRA
SRIVARU Holding Limited	SVMH
Shuttle Pharmaceuticals Holdings, Inc.	SHPH
OpGen, Inc.	OPGN
First Wave BioPharma, Inc.	FWBI
Xenetic Biosciences, Inc.	XBIO
Ayro, Inc.	AYRO
SOBR Safe, Inc.	SOBR
Titan Pharmaceuticals, Inc.	TTNP
BTC Digital Ltd.	BTCT
Carver Bancorp, Inc.	CARV
LQR House Inc.	LQR
Cadrenal Therapeutics, Inc.	CVKD
Gamer Pakistan Inc.	GPAK
Eightco Holdings Inc.	OCTO
Energy Focus, Inc.	EFOI
Collective Audience, Inc.	CAUD
1847 Holdings LLC	EFSH
Applied DNA Sciences, Inc.	APDN
Protagenic Therapeutics, Inc.	PTIX
Infobird Co., Ltd	IFBD
Nuburu, Inc.	BURU
Seelos Therapeutics, Inc.	SEEL
Ainos, Inc.	AIMD
Rail Vision Ltd.	RVSN
Universe Pharmaceuticals INC	UPC
PaxMedica, Inc.	PXMD
New Concept Energy, Inc.	GBR
Sonnet BioTherapeutics Holdings, Inc.	SONN
Nxu, Inc.	NXU
Brenmiller Energy Ltd	BNRG
XTI Aerospace, Inc.	XTIA
Avenue Therapeutics, Inc.	ATXI
Sentage Holdings Inc.	SNTG
Boxlight Corporation	BOXL
Digital Ally, Inc.	DGLY
XWELL, Inc.	XWEL
NLS Pharmaceutics AG	NLSP
Aditxt, Inc.	ADTX
Oxbridge Re Holdings Limited	OXBR
22nd Century Group, Inc.	XXII
Alzamend Neuro, Inc.	ALZN
Asset Entities Inc.	ASST
Trevena, Inc.	TRVN
Moving iMage Technologies, Inc.	MITQ
Scorpius Holdings, Inc.	SCPX
Petros Pharmaceuticals, Inc.	PTPI
Mangoceuticals, Inc.	MGRX
Alset EHome International Inc.	AEI
Sharps Technology, Inc.	STSS
Intrusion Inc.	INTZ
Silo Pharma, Inc.	SILO
Nature's Miracle Holding Inc.	NMHI
OMNIQ Corp.	OMQS
CN Energy Group. Inc.	CNEY
Oragenics, Inc.	OGEN
Bright Minds Biosciences Inc.	DRUG
Helius Medical Technologies, Inc.	HSDT
China Pharma Holdings, Inc.	CPHI
CalAmp Corp.	CAMP
The Singing Machine Company, Inc.	MICS
Leafly Holdings, Inc.	LFLY
ZyVersa Therapeutics, Inc.	ZVSA
GT Biopharma, Inc.	GTBP
Forward Industries, Inc.	FORD
Hoth Therapeutics, Inc.	HOTH
GD Culture Group Limited	GDC
Amesite Inc.	AMST
Farmmi, Inc.	FAMI
Momentus Inc.	MNTS
BranchOut Food Inc.	BOF
Mustang Bio, Inc.	MBIO
Acutus Medical, Inc.	AFIB
MyMD Pharmaceuticals, Inc.	MYMD
Chicken Soup for the Soul Entertainment, Inc.	CSSE
Regional Health Properties, Inc.	RHE
Genprex, Inc.	GNPX
Better Choice Company Inc.	BTTR
Volcon, Inc.	VLCN
Oriental Culture Holding LTD	OCG
Synaptogenix, Inc.	SNPX
Baosheng Media Group Holdings Limited	BAOS
China Jo-Jo Drugstores, Inc.	CJJD
Azitra, Inc.	AZTR
Exicure, Inc.	XCUR
Lytus Technologies Holdings PTV. Ltd.	LYT
Locafy Limited	LCFY
Artelo Biosciences, Inc.	ARTL
Kaixin Auto Holdings	KXIN
SunLink Health Systems, Inc.	SSY
Yoshiharu Global Co.	YOSH
Treasure Global Inc.	TGL
Yield10 Bioscience, Inc.	YTEN
Processa Pharmaceuticals, Inc.	PCSA
SharpLink Gaming Ltd.	SBET
Ambow Education Holding Ltd.	AMBO
BIOLASE, Inc.	BIOL
Soluna Holdings, Inc.	SLNH
Assure Holdings Corp.	IONM
Shineco, Inc.	SISI
ReTo Eco-Solutions, Inc.	RETO
Auddia Inc.	AUUD
Tharimmune, Inc.	THAR
MGO Global Inc.	MGOL
Versus Systems Inc.	VS
Integrated Media Technology Limited	IMTE
Stryve Foods, Inc.	SNAX
Green Giant Inc.	GGE
Inspire Veterinary Partners, Inc.	IVP
Lipella Pharmaceuticals Inc.	LIPO
Evoke Pharma, Inc.	EVOK
Society Pass Incorporated	SOPA
Arcimoto, Inc.	FUV
SenesTech, Inc.	SNES
Venus Concept Inc.	VERO
Biophytis S.A.	BPTS
NexImmune, Inc.	NEXI
WaveDancer, Inc.	WAVD
Medigus Ltd.	MDGS
Longeveron Inc.	LGVN
Gaucho Group Holdings, Inc.	VINO
Tritium DCFC Limited	DCFC
Nuvve Holding Corp.	NVVE
CEA Industries Inc.	CEAD
Virpax Pharmaceuticals, Inc.	VRPX
Hempacco Co., Inc.	HPCO
N2OFF, Inc.	NITO
ENDRA Life Sciences Inc.	NDRA
TransCode Therapeutics, Inc.	RNAZ
Interactive Strength Inc.	TRNR
Soligenix, Inc.	SNGX
Kineta, Inc.	KA
Aethlon Medical, Inc.	AEMD
Clearmind Medicine Inc.	CMND
SciSparc Ltd.	SPRC
NextTrip, Inc.	NTRP
ReShape Lifesciences Inc.	RSLS
Universal Security Instruments, Inc.	UUU
WiSA Technologies, Inc.	WISA
Addentax Group Corp.	ATXG
Nova LifeStyle, Inc.	NVFY
GeoVax Labs, Inc.	GOVX
Windtree Therapeutics, Inc.	WINT
Cingulate Inc.	CING
Digital Brands Group, Inc.	DBGI
JE Cleantech Holdings Limited	JCSE
AgriFORCE Growing Systems Ltd.	AGRI
Innovative Eyewear, Inc.	LUCY
Cemtrex, Inc.	CETX
Avalon GloboCare Corp.	ALBT
IMAC Holdings, Inc.	BACK
DatChat, Inc.	DATS
Catheter Precision, Inc.	VTAK
Revelation Biosciences, Inc.	REVB
Faraday Future Intelligent Electric Inc.	FFIE
Pineapple Energy Inc.	PEGY
BIO-key International, Inc.	BKYI
Finch Therapeutics Group, Inc.	FNCH
Meiwu Technology Company Limited	WNW
China Liberal Education Holdings Limited	CLEU
Next.e.GO N.V.	EGOX
Quhuo Limited	QH
Blue Star Foods Corp.	BSFC
Onconetix, Inc.	ONCO
Bruush Oral Care Inc.	BRSH
Phio Pharmaceuticals Corp.	PHIO
Mobile Global Esports Inc.	MGAM
60 Degrees Pharmaceuticals, Inc.	SXTP
TuanChe Limited	TC
Tenon Medical, Inc.	TNON
Safe & Green Holdings Corp	SGBX
Reborn Coffee, Inc.	REBN
Lixiang Education Holding Co., Ltd.	LXEH
Sintx Technologies, Inc.	SINT
Altamira Therapeutics Ltd.	CYTO
UTime Limited	WTO
KWESST Micro Systems Inc.	KWE
FLJ Group Limited	FLJ
Crown ElectroKinetics Corp.	CRKN
FOXO Technologies Inc.	FOXO
Peraso Inc.	PRSO
cbdMD, Inc.	YCBD
NextPlay Technologies, Inc.	NXTP
Dermata Therapeutics, Inc.	DRMA
Sonoma Pharmaceuticals, Inc.	SNOA
Jowell Global Ltd.	JWEL
NovaBay Pharmaceuticals, Inc.	NBY
Vocodia Holdings Corp	VHAI
SCWorx Corp.	WORX
Arcadia Biosciences, Inc.	RKDA
Actelis Networks, Inc.	ASNS
CNS Pharmaceuticals, Inc.	CNSP
ThermoGenesis Holdings, Inc.	THMO
IT Tech Packaging, Inc.	ITP
SuperCom Ltd.	SPCB
Secoo Holding Limited	SECO
Tantech Holdings Ltd	TANH
Netcapital Inc.	NCPL
Nuwellis, Inc.	NUWE
Staffing 360 Solutions, Inc.	STAF
Agrify Corporation	AGFY
Applied UV, Inc.	AUVI
Color Star Technology Co., Ltd.	ADD
Ensysce Biosciences, Inc.	ENSC
Cyclacel Pharmaceuticals, Inc.	CYCC
Freight Technologies, Inc.	FRGT
Bio-Path Holdings, Inc.	BPTH
Greenlane Holdings, Inc.	GNLN
Aclarion, Inc.	ACON
Recruiter.com Group, Inc.	RCRT
Lucy Scientific Discovery Inc.	LSDI
Salarius Pharmaceuticals, Inc.	SLRX
AERWINS Technologies Inc.	AWIN
Oblong, Inc.	OBLG
INVO Bioscience, Inc.	INVO
Onfolio Holdings, Inc.	ONFO
American Rebel Holdings, Inc.	AREB
NanoVibronix, Inc.	NAOV
Qualigen Therapeutics, Inc.	QLGN
Scinai Immunotherapeutics Ltd.	SCNI
iSpecimen Inc.	ISPC
Siyata Mobile Inc.	SYTA
Greenwave Technology Solutions, Inc.	GWAV
InMed Pharmaceuticals Inc.	INM
LogicMark, Inc.	LGMK
Dynatronics Corporation	DYNT
PainReform Ltd.	PRFX
ToughBuilt Industries, Inc.	TBLT
Reliance Global Group, Inc.	RELI
Power REIT	PW
Akanda Corp.	AKAN
180 Life Sciences Corp.	ATNF
Virax Biolabs Group Limited	VRAX
Edible Garden AG Incorporated	EDBL
Tivic Health Systems, Inc.	TIVC
Bluejay Diagnostics, Inc.	BJDX
TC Biopharm (Holdings) Plc	TCBP
Taoping Inc.	TAOP
Tian Ruixiang Holdings Ltd	TIRX
NeuBase Therapeutics, Inc.	NBSE
GRI Bio, Inc.	GRI
Galmed Pharmaceuticals Ltd.	GLMD
Eastside Distilling, Inc.	EAST
Boqii Holding Limited	BQ
NuZee, Inc.	NUZE
Bone Biologics Corporation	BBLG
My Size, Inc.	MYSZ
Grom Social Enterprises, Inc.	GROM
Motus GI Holdings, Inc.	MOTS
Ucommune International Ltd	UK
Allarity Therapeutics, Inc.	ALLR
Lion Group Holding Ltd.	LGHL
SMX (Security Matters) PLC	SMX
Quoin Pharmaceuticals, Ltd.	QNRX
Dunxin Financial Holdings Limited	DXF
BYND Cannasoft Enterprises Inc.	BCAN
Aptevo Therapeutics Inc.	APVO
Ampio Pharmaceuticals, Inc.	AMPE
Ascent Solar Technologies, Inc.	ASTI
Jeffs' Brands Ltd	JFBR
Biodexa Pharmaceuticals Plc	BDRX
Aimfinity Investment Corp. I	AIMAU